т╜З	a	х║╖чЖЩщГищжЦ
т╜И	a	х║╖чЖЩщГищжЦ
т┐▒	a	шбицДПцЦЗхнЧцППш┐░хнЧчмж
уН╛	aber	ф╕нцЧещЯУхЕ╝хо╣чмжшЩЯ
язЕ	abjj	ф╕нцЧещЯУхЕ╝хо╣шбицДПцЦЗхнЧ
ЁпгТ	abu	ф╕нцЧещЯУхЕ╝хо╣шбицДПцЦЗхнЧшгЬхЕЕ
ЁпзК	abuu	ф╕нцЧещЯУхЕ╝хо╣шбицДПцЦЗхнЧшгЬхЕЕ
ЁпгО	aikf	ф╕нцЧещЯУхЕ╝хо╣шбицДПцЦЗхнЧшгЬхЕЕ
ЁпгС	aine	ф╕нцЧещЯУхЕ╝хо╣шбицДПцЦЗхнЧшгЬхЕЕ
ЁпиО	aislf	ф╕нцЧещЯУхЕ╝хо╣шбицДПцЦЗхнЧшгЬхЕЕ
яйГ	ajka	ф╕нцЧещЯУхЕ╝хо╣шбицДПцЦЗхнЧ
ЁпгП	ajka	ф╕нцЧещЯУхЕ╝хо╣шбицДПцЦЗхнЧшгЬхЕЕ
яе╛	amwg	ф╕нцЧещЯУхЕ╝хо╣шбицДПцЦЗхнЧ
т╛и	an	х║╖чЖЩщГищжЦ
ЁпгУ	anau	ф╕нцЧещЯУхЕ╝хо╣шбицДПцЦЗхнЧшгЬхЕЕ
Ёпзо	anmjj	ф╕нцЧещЯУхЕ╝хо╣шбицДПцЦЗхнЧшгЬхЕЕ
яжЖ	anrhr	ф╕нцЧещЯУхЕ╝хо╣шбицДПцЦЗхнЧ
Ёпз▒	anwot	ф╕нцЧещЯУхЕ╝хо╣шбицДПцЦЗхнЧшгЬхЕЕ
Ёпзп	anyjj	ф╕нцЧещЯУхЕ╝хо╣шбицДПцЦЗхнЧшгЬхЕЕ
яза	aphh	ф╕нцЧещЯУхЕ╝хо╣шбицДПцЦЗхнЧ
Ёпап	apsl	ф╕нцЧещЯУхЕ╝хо╣шбицДПцЦЗхнЧшгЬхЕЕ
яиТ	aqmb	ф╕нцЧещЯУхЕ╝хо╣шбицДПцЦЗхнЧ
якС	aqmb	ф╕нцЧещЯУхЕ╝хо╣шбицДПцЦЗхнЧ
ЁпгФ	asje	ф╕нцЧещЯУхЕ╝хо╣шбицДПцЦЗхнЧшгЬхЕЕ
уН╝	asrr	ф╕нцЧещЯУхЕ╝хо╣чмжшЩЯ
яиЖ	atce	ф╕нцЧещЯУхЕ╝хо╣шбицДПцЦЗхнЧ
т╛Й	av	х║╖чЖЩщГищжЦ
ЁпгР	awot	ф╕нцЧещЯУхЕ╝хо╣шбицДПцЦЗхнЧшгЬхЕЕ
т╜Й	b	х║╖чЖЩщГищжЦ
т║Э	b	ф╕нцЧещЯУщГищжЦшгЬхЕЕ
т║╝	b	ф╕нцЧещЯУщГищжЦшгЬхЕЕ
т╛╗	bbb	х║╖чЖЩщГищжЦ
т╗г	bbb	ф╕нцЧещЯУщГищжЦшгЬхЕЕ
ЁпаЦ	bbmm	ф╕нцЧещЯУхЕ╝хо╣шбицДПцЦЗхнЧшгЬхЕЕ
ЁпиИ	bbomj	ф╕нцЧещЯУхЕ╝хо╣шбицДПцЦЗхнЧшгЬхЕЕ
ядЫ	bbu	ф╕нцЧещЯУхЕ╝хо╣шбицДПцЦЗхнЧ
ЁпиЪ	bbul	ф╕нцЧещЯУхЕ╝хо╣шбицДПцЦЗхнЧшгЬхЕЕ
ЁпиЪ	bbun	ф╕нцЧещЯУхЕ╝хо╣шбицДПцЦЗхнЧшгЬхЕЕ
т║│	bc	ф╕нцЧещЯУщГищжЦшгЬхЕЕ
яйе	bccwa	ф╕нцЧещЯУхЕ╝хо╣шбицДПцЦЗхнЧ
ялБ	bccwa	ф╕нцЧещЯУхЕ╝хо╣шбицДПцЦЗхнЧ
яеИ	bcher	ф╕нцЧещЯУхЕ╝хо╣шбицДПцЦЗхнЧ
ЁпжД	bcip	ф╕нцЧещЯУхЕ╝хо╣шбицДПцЦЗхнЧшгЬхЕЕ
яз╗	bf	ф╕нцЧещЯУхЕ╝хо╣шбицДПцЦЗхнЧ
ЁпжЖ	bfqv	ф╕нцЧещЯУхЕ╝хо╣шбицДПцЦЗхнЧшгЬхЕЕ
якЭ	bgf	ф╕нцЧещЯУхЕ╝хо╣шбицДПцЦЗхнЧ
ЁпжИ	bham	ф╕нцЧещЯУхЕ╝хо╣шбицДПцЦЗхнЧшгЬхЕЕ
ЁпжЗ	bhhw	ф╕нцЧещЯУхЕ╝хо╣шбицДПцЦЗхнЧшгЬхЕЕ
ЁпзУ	bhmjj	ф╕нцЧещЯУхЕ╝хо╣шбицДПцЦЗхнЧшгЬхЕЕ
ЁпаЧ	bhu	ф╕нцЧещЯУхЕ╝хо╣шбицДПцЦЗхнЧшгЬхЕЕ
т║┤	bhu	ф╕нцЧещЯУщГищжЦшгЬхЕЕ
т╗Е	bhu	ф╕нцЧещЯУщГищжЦшгЬхЕЕ
т║╝	bim	ф╕нцЧещЯУщГищжЦшгЬхЕЕ
т║▒	bk	ф╕нцЧещЯУщГищжЦшгЬхЕЕ
т╜╣	bkk	х║╖чЖЩщГищжЦ
Ёпе╡	bkkhu	ф╕нцЧещЯУхЕ╝хо╣шбицДПцЦЗхнЧшгЬхЕЕ
яеУ	bks	ф╕нцЧещЯУхЕ╝хо╣шбицДПцЦЗхнЧ
ЁпгЧ	blbu	ф╕нцЧещЯУхЕ╝хо╣шбицДПцЦЗхнЧшгЬхЕЕ
т║╡	bll	ф╕нцЧещЯУщГищжЦшгЬхЕЕ
т╝Ю	bm	х║╖чЖЩщГищжЦ
ЁпжА	bmb	ф╕нцЧещЯУхЕ╝хо╣шбицДПцЦЗхнЧшгЬхЕЕ
ЁпжБ	bmg	ф╕нцЧещЯУхЕ╝хо╣шбицДПцЦЗхнЧшгЬхЕЕ
т║Ь	bmm	ф╕нцЧещЯУщГищжЦшгЬхЕЕ
ЁпжГ	bnau	ф╕нцЧещЯУхЕ╝хо╣шбицДПцЦЗхнЧшгЬхЕЕ
т╗Й	bo	ф╕нцЧещЯУщГищжЦшгЬхЕЕ
ЁпгЦ	bob	ф╕нцЧещЯУхЕ╝хо╣шбицДПцЦЗхнЧшгЬхЕЕ
т╜д	bq	х║╖чЖЩщГищжЦ
Ёпа┐	bqr	ф╕нцЧещЯУхЕ╝хо╣шбицДПцЦЗхнЧшгЬхЕЕ
ЁпвЪ	brhhh	ф╕нцЧещЯУхЕ╝хо╣шбицДПцЦЗхнЧшгЬхЕЕ
ЁпжК	brxu	ф╕нцЧещЯУхЕ╝хо╣шбицДПцЦЗхнЧшгЬхЕЕ
т╛Ш	bshh	х║╖чЖЩщГищжЦ
ЁпаШ	bshi	ф╕нцЧещЯУхЕ╝хо╣шбицДПцЦЗхнЧшгЬхЕЕ
т╜л	bt	х║╖чЖЩщГищжЦ
т╜м	bu	х║╖чЖЩщГищжЦ
т┐│	bu	шбицДПцЦЗхнЧцППш┐░хнЧчмж
т╛Щ	buc	х║╖чЖЩщГищжЦ
ЁпгЪ	buce	ф╕нцЧещЯУхЕ╝хо╣шбицДПцЦЗхнЧшгЬхЕЕ
яиК	buhu	ф╕нцЧещЯУхЕ╝хо╣шбицДПцЦЗхнЧ
т╛Т	buhu	х║╖чЖЩщГищжЦ
якй	buib	ф╕нцЧещЯУхЕ╝хо╣шбицДПцЦЗхнЧ
ЁпеИ	buib	ф╕нцЧещЯУхЕ╝хо╣шбицДПцЦЗхнЧшгЬхЕЕ
ЁпеЛ	bukhu	ф╕нцЧещЯУхЕ╝хо╣шбицДПцЦЗхнЧшгЬхЕЕ
ялФ	bukoo	ф╕нцЧещЯУхЕ╝хо╣шбицДПцЦЗхнЧ
ЁпеЙ	bukoo	ф╕нцЧещЯУхЕ╝хо╣шбицДПцЦЗхнЧшгЬхЕЕ
ЁпаС	bumc	ф╕нцЧещЯУхЕ╝хо╣шбицДПцЦЗхнЧшгЬхЕЕ
ЁпеГ	bumf	ф╕нцЧещЯУхЕ╝хо╣шбицДПцЦЗхнЧшгЬхЕЕ
ялУ	bumjj	ф╕нцЧещЯУхЕ╝хо╣шбицДПцЦЗхнЧ
ЁпеБ	bumms	ф╕нцЧещЯУхЕ╝хо╣шбицДПцЦЗхнЧшгЬхЕЕ
ялХ	buold	ф╕нцЧещЯУхЕ╝хо╣шбицДПцЦЗхнЧ
ЁпеК	bupbc	ф╕нцЧещЯУхЕ╝хо╣шбицДПцЦЗхнЧшгЬхЕЕ
ЁпеВ	but	ф╕нцЧещЯУхЕ╝хо╣шбицДПцЦЗхнЧшгЬхЕЕ
т┐Н	buvml	х║╖чЖЩщГищжЦ
ядж	bvvv	ф╕нцЧещЯУхЕ╝хо╣шбицДПцЦЗхнЧ
ЁпжЕ	bwhj	ф╕нцЧещЯУхЕ╝хо╣шбицДПцЦЗхнЧшгЬхЕЕ
якЮ	bwli	ф╕нцЧещЯУхЕ╝хо╣шбицДПцЦЗхнЧ
Ёпдб	bwli	ф╕нцЧещЯУхЕ╝хо╣шбицДПцЦЗхнЧшгЬхЕЕ
яеЮ	by	ф╕нцЧещЯУхЕ╝хо╣шбицДПцЦЗхнЧ
ЁпжЙ	byso	ф╕нцЧещЯУхЕ╝хо╣шбицДПцЦЗхнЧшгЬхЕЕ
ядК	c	ф╕нцЧещЯУхЕ╝хо╣шбицДПцЦЗхнЧ
т╛ж	c	х║╖чЖЩщГищжЦ
яжЫ	cdwf	ф╕нцЧещЯУхЕ╝хо╣шбицДПцЦЗхнЧ
т║С	chn	ф╕нцЧещЯУщГищжЦшгЬхЕЕ
т║П	chu	ф╕нцЧещЯУщГищжЦшгЬхЕЕ
Ёпзн	chxf	ф╕нцЧещЯУхЕ╝хо╣шбицДПцЦЗхнЧшгЬхЕЕ
Ёпзи	cib	ф╕нцЧещЯУхЕ╝хо╣шбицДПцЦЗхнЧшгЬхЕЕ
Ёпзз	cike	ф╕нцЧещЯУхЕ╝хо╣шбицДПцЦЗхнЧшгЬхЕЕ
т╜Ч	ck	х║╖чЖЩщГищжЦ
Ёпзм	ckua	ф╕нцЧещЯУхЕ╝хо╣шбицДПцЦЗхнЧшгЬхЕЕ
яиЧ	cmct	ф╕нцЧещЯУхЕ╝хо╣шбицДПцЦЗхнЧ
ялЕ	cmjn	ф╕нцЧещЯУхЕ╝хо╣шбицДПцЦЗхнЧ
Ёпзл	cnri	ф╕нцЧещЯУхЕ╝хо╣шбицДПцЦЗхнЧшгЬхЕЕ
яж▒	coml	ф╕нцЧещЯУхЕ╝хо╣шбицДПцЦЗхнЧ
т╛Х	cor	х║╖чЖЩщГищжЦ
Ёпзй	crvk	ф╕нцЧещЯУхЕ╝хо╣шбицДПцЦЗхнЧшгЬхЕЕ
яд┐	cvne	ф╕нцЧещЯУхЕ╝хо╣шбицДПцЦЗхнЧ
Ёпзк	cyjj	ф╕нцЧещЯУхЕ╝хо╣шбицДПцЦЗхнЧшгЬхЕЕ
т╜К	d	х║╖чЖЩщГищжЦ
ядЭ	danw	ф╕нцЧещЯУхЕ╝хо╣шбицДПцЦЗхнЧ
Ёпгг	dbbm	ф╕нцЧещЯУхЕ╝хо╣шбицДПцЦЗхнЧшгЬхЕЕ
яз┐	dbln	ф╕нцЧещЯУхЕ╝хо╣шбицДПцЦЗхнЧ
Ёпгй	dbou	ф╕нцЧещЯУхЕ╝хо╣шбицДПцЦЗхнЧшгЬхЕЕ
ялТ	dcrl	ф╕нцЧещЯУхЕ╝хо╣шбицДПцЦЗхнЧ
Ёпгз	dcrl	ф╕нцЧещЯУхЕ╝хо╣шбицДПцЦЗхнЧшгЬхЕЕ
яз┤	dd	ф╕нцЧещЯУхЕ╝хо╣шбицДПцЦЗхнЧ
Ёпги	ddbm	ф╕нцЧещЯУхЕ╝хо╣шбицДПцЦЗхнЧшгЬхЕЕ
ЁпаЯ	deln	ф╕нцЧещЯУхЕ╝хо╣шбицДПцЦЗхнЧшгЬхЕЕ
Ёпгн	dhal	ф╕нцЧещЯУхЕ╝хо╣шбицДПцЦЗхнЧшгЬхЕЕ
Ёпгд	dhap	ф╕нцЧещЯУхЕ╝хо╣шбицДПцЦЗхнЧшгЬхЕЕ
т╜к	dhe	х║╖чЖЩщГищжЦ
язЙ	dhhl	ф╕нцЧещЯУхЕ╝хо╣шбицДПцЦЗхнЧ
Ёпгк	dhpu	ф╕нцЧещЯУхЕ╝хо╣шбицДПцЦЗхнЧшгЬхЕЕ
т╝и	di	х║╖чЖЩщГищжЦ
ялС	dijc	ф╕нцЧещЯУхЕ╝хо╣шбицДПцЦЗхнЧ
якФ	dijk	ф╕нцЧещЯУхЕ╝хо╣шбицДПцЦЗхнЧ
ЁпгЭ	dl	ф╕нцЧещЯУхЕ╝хо╣шбицДПцЦЗхнЧшгЬхЕЕ
яеМ	dllv	ф╕нцЧещЯУхЕ╝хо╣шбицДПцЦЗхнЧ
ЁпиУ	dlmcf	ф╕нцЧещЯУхЕ╝хо╣шбицДПцЦЗхнЧшгЬхЕЕ
т║Ш	dm	ф╕нцЧещЯУщГищжЦшгЬхЕЕ
Ёпга	dmjj	ф╕нцЧещЯУхЕ╝хо╣шбицДПцЦЗхнЧшгЬхЕЕ
уН┐	dmoig	ф╕нцЧещЯУхЕ╝хо╣чмжшЩЯ
т╛▒	dmrq	х║╖чЖЩщГищжЦ
язб	dnd	ф╕нцЧещЯУхЕ╝хо╣шбицДПцЦЗхнЧ
язИ	dng	ф╕нцЧещЯУхЕ╝хо╣шбицДПцЦЗхнЧ
Ёпе╛	dnsj	ф╕нцЧещЯУхЕ╝хо╣шбицДПцЦЗхнЧшгЬхЕЕ
яд▒	dnwa	ф╕нцЧещЯУхЕ╝хо╣шбицДПцЦЗхнЧ
т┐Ж	doni	х║╖чЖЩщГищжЦ
ядн	doo	ф╕нцЧещЯУхЕ╝хо╣шбицДПцЦЗхнЧ
Ёпгв	dowj	ф╕нцЧещЯУхЕ╝хо╣шбицДПцЦЗхнЧшгЬхЕЕ
яйД	dowy	ф╕нцЧещЯУхЕ╝хо╣шбицДПцЦЗхнЧ
ЁпгЬ	dpm	ф╕нцЧещЯУхЕ╝хо╣шбицДПцЦЗхнЧшгЬхЕЕ
ялЙ	dqthb	ф╕нцЧещЯУхЕ╝хо╣шбицДПцЦЗхнЧ
Ёпз║	dqwtj	ф╕нцЧещЯУхЕ╝хо╣шбицДПцЦЗхнЧшгЬхЕЕ
ЁпгЯ	drks	ф╕нцЧещЯУхЕ╝хо╣шбицДПцЦЗхнЧшгЬхЕЕ
ЁпгЭ	dsm	ф╕нцЧещЯУхЕ╝хо╣шбицДПцЦЗхнЧшгЬхЕЕ
Ёпго	dsmt	ф╕нцЧещЯУхЕ╝хо╣шбицДПцЦЗхнЧшгЬхЕЕ
ЁпгЫ	dsu	ф╕нцЧещЯУхЕ╝хо╣шбицДПцЦЗхнЧшгЬхЕЕ
Ёпгл	dtgo	ф╕нцЧещЯУхЕ╝хо╣шбицДПцЦЗхнЧшгЬхЕЕ
Ёпгж	dvmw	ф╕нцЧещЯУхЕ╝хо╣шбицДПцЦЗхнЧшгЬхЕЕ
Ёпгм	dwtc	ф╕нцЧещЯУхЕ╝хо╣шбицДПцЦЗхнЧшгЬхЕЕ
Ёпге	dyjj	ф╕нцЧещЯУхЕ╝хо╣шбицДПцЦЗхнЧшгЬхЕЕ
т╜Ф	e	х║╖чЖЩщГищжЦ
ЁпдР	eahr	ф╕нцЧещЯУхЕ╝хо╣шбицДПцЦЗхнЧшгЬхЕЕ
ЁпдЕ	eam	ф╕нцЧещЯУхЕ╝хо╣шбицДПцЦЗхнЧшгЬхЕЕ
ядД	ebbb	ф╕нцЧещЯУхЕ╝хо╣шбицДПцЦЗхнЧ
яиЕ	ebmr	ф╕нцЧещЯУхЕ╝хо╣шбицДПцЦЗхнЧ
якШ	ebmu	ф╕нцЧещЯУхЕ╝хо╣шбицДПцЦЗхнЧ
яе║	ecd	ф╕нцЧещЯУхЕ╝хо╣шбицДПцЦЗхнЧ
ЁпдЖ	ecsg	ф╕нцЧещЯУхЕ╝хо╣шбицДПцЦЗхнЧшгЬхЕЕ
яз╡	edd	ф╕нцЧещЯУхЕ╝хо╣шбицДПцЦЗхнЧ
ЁпдК	egih	ф╕нцЧещЯУхЕ╝хо╣шбицДПцЦЗхнЧшгЬхЕЕ
ядХ	eher	ф╕нцЧещЯУхЕ╝хо╣шбицДПцЦЗхнЧ
ЁпдА	ehhv	ф╕нцЧещЯУхЕ╝хо╣шбицДПцЦЗхнЧшгЬхЕЕ
язЛ	ehhw	ф╕нцЧещЯУхЕ╝хо╣шбицДПцЦЗхнЧ
Ёпг╝	ehnr	ф╕нцЧещЯУхЕ╝хо╣шбицДПцЦЗхнЧшгЬхЕЕ
ЁпдГ	ehqr	ф╕нцЧещЯУхЕ╝хо╣шбицДПцЦЗхнЧшгЬхЕЕ
яеН	ehsk	ф╕нцЧещЯУхЕ╝хо╣шбицДПцЦЗхнЧ
ядк	eiav	ф╕нцЧещЯУхЕ╝хо╣шбицДПцЦЗхнЧ
ЁпдП	ejjb	ф╕нцЧещЯУхЕ╝хо╣шбицДПцЦЗхнЧшгЬхЕЕ
яйЖ	ejka	ф╕нцЧещЯУхЕ╝хо╣шбицДПцЦЗхнЧ
ЁпдТ	ejtc	ф╕нцЧещЯУхЕ╝хо╣шбицДПцЦЗхнЧшгЬхЕЕ
ЁпдН	ekce	ф╕нцЧещЯУхЕ╝хо╣шбицДПцЦЗхнЧшгЬхЕЕ
ЁпдО	ekhu	ф╕нцЧещЯУхЕ╝хо╣шбицДПцЦЗхнЧшгЬхЕЕ
ЁпдЧ	ekub	ф╕нцЧещЯУхЕ╝хо╣шбицДПцЦЗхнЧшгЬхЕЕ
Ёпг╗	elbn	ф╕нцЧещЯУхЕ╝хо╣шбицДПцЦЗхнЧшгЬхЕЕ
яе▓	elbu	ф╕нцЧещЯУхЕ╝хо╣шбицДПцЦЗхнЧ
ЁпдС	emef	ф╕нцЧещЯУхЕ╝хо╣шбицДПцЦЗхнЧшгЬхЕЕ
Ёпг╛	emjj	ф╕нцЧещЯУхЕ╝хо╣шбицДПцЦЗхнЧшгЬхЕЕ
ЁпдЙ	emwg	ф╕нцЧещЯУхЕ╝хо╣шбицДПцЦЗхнЧшгЬхЕЕ
язм	enhh	ф╕нцЧещЯУхЕ╝хо╣шбицДПцЦЗхнЧ
Ёпг║	enhi	ф╕нцЧещЯУхЕ╝хо╣шбицДПцЦЗхнЧшгЬхЕЕ
ЁпдЦ	eolf	ф╕нцЧещЯУхЕ╝хо╣шбицДПцЦЗхнЧшгЬхЕЕ
язЦ	eomb	ф╕нцЧещЯУхЕ╝хо╣шбицДПцЦЗхнЧ
ЁпдУ	eomb	ф╕нцЧещЯУхЕ╝хо╣шбицДПцЦЗхнЧшгЬхЕЕ
ЁпдБ	eowj	ф╕нцЧещЯУхЕ╝хо╣шбицДПцЦЗхнЧшгЬхЕЕ
яйЕ	eowy	ф╕нцЧещЯУхЕ╝хо╣шбицДПцЦЗхнЧ
ЁпдМ	epbc	ф╕нцЧещЯУхЕ╝хо╣шбицДПцЦЗхнЧшгЬхЕЕ
яеи	eph	ф╕нцЧещЯУхЕ╝хо╣шбицДПцЦЗхнЧ
якЫ	eqbd	ф╕нцЧещЯУхЕ╝хо╣шбицДПцЦЗхнЧ
ЁпдФ	eqbd	ф╕нцЧещЯУхЕ╝хо╣шбицДПцЦЗхнЧшгЬхЕЕ
Ёпг╜	eqc	ф╕нцЧещЯУхЕ╝хо╣шбицДПцЦЗхнЧшгЬхЕЕ
Ёпг┐	ervk	ф╕нцЧещЯУхЕ╝хо╣шбицДПцЦЗхнЧшгЬхЕЕ
яеО	esmb	ф╕нцЧещЯУхЕ╝хо╣шбицДПцЦЗхнЧ
ЁпдД	esme	ф╕нцЧещЯУхЕ╝хо╣шбицДПцЦЗхнЧшгЬхЕЕ
ядв	esmt	ф╕нцЧещЯУхЕ╝хо╣шбицДПцЦЗхнЧ
язг	esp	ф╕нцЧещЯУхЕ╝хо╣шбицДПцЦЗхнЧ
якЪ	etao	ф╕нцЧещЯУхЕ╝хо╣шбицДПцЦЗхнЧ
ЁпдИ	etcu	ф╕нцЧещЯУхЕ╝хо╣шбицДПцЦЗхнЧшгЬхЕЕ
яйЗ	etlo	ф╕нцЧещЯУхЕ╝хо╣шбицДПцЦЗхнЧ
якЩ	etvi	ф╕нцЧещЯУхЕ╝хо╣шбицДПцЦЗхнЧ
ЁпдЛ	etvi	ф╕нцЧещЯУхЕ╝хо╣шбицДПцЦЗхнЧшгЬхЕЕ
язК	eyiu	ф╕нцЧещЯУхЕ╝хо╣шбицДПцЦЗхнЧ
якЧ	eyiu	ф╕нцЧещЯУхЕ╝хо╣шбицДПцЦЗхнЧ
ЁпдВ	eyiv	ф╕нцЧещЯУхЕ╝хо╣шбицДПцЦЗхнЧшгЬхЕЕ
яжТ	eyjj	ф╕нцЧещЯУхЕ╝хо╣шбицДПцЦЗхнЧ
ЁпдЗ	eyjj	ф╕нцЧещЯУхЕ╝хо╣шбицДПцЦЗхнЧшгЬхЕЕ
яжД	eypp	ф╕нцЧещЯУхЕ╝хо╣шбицДПцЦЗхнЧ
ЁпдХ	eyqv	ф╕нцЧещЯУхЕ╝хо╣шбицДПцЦЗхнЧшгЬхЕЕ
т╜Х	f	х║╖чЖЩщГищжЦ
ядЮ	fanw	ф╕нцЧещЯУхЕ╝хо╣шбицДПцЦЗхнЧ
т╜╢	fd	х║╖чЖЩщГищжЦ
яе╗	fdamg	ф╕нцЧещЯУхЕ╝хо╣шбицДПцЦЗхнЧ
яко	fdik	ф╕нцЧещЯУхЕ╝хо╣шбицДПцЦЗхнЧ
яиГ	fdilr	ф╕нцЧещЯУхЕ╝хо╣шбицДПцЦЗхнЧ
Ёпей	fdkua	ф╕нцЧещЯУхЕ╝хо╣шбицДПцЦЗхнЧшгЬхЕЕ
Ёпеи	fdnri	ф╕нцЧещЯУхЕ╝хо╣шбицДПцЦЗхнЧшгЬхЕЕ
яиЭ	fdqmb	ф╕нцЧещЯУхЕ╝хо╣шбицДПцЦЗхнЧ
Ёпеж	fdthb	ф╕нцЧещЯУхЕ╝хо╣шбицДПцЦЗхнЧшгЬхЕЕ
яжУ	fdwf	ф╕нцЧещЯУхЕ╝хо╣шбицДПцЦЗхнЧ
яж╛	fdyj	ф╕нцЧещЯУхЕ╝хо╣шбицДПцЦЗхнЧ
яз╣	fdyt	ф╕нцЧещЯУхЕ╝хо╣шбицДПцЦЗхнЧ
т║в	ff	ф╕нцЧещЯУщГищжЦшгЬхЕЕ
ядп	ffbks	ф╕нцЧещЯУхЕ╝хо╣шбицДПцЦЗхнЧ
яжо	ffbmi	ф╕нцЧещЯУхЕ╝хо╣шбицДПцЦЗхнЧ
язо	ffdq	ф╕нцЧещЯУхЕ╝хо╣шбицДПцЦЗхнЧ
ЁпдЯ	ffto	ф╕нцЧещЯУхЕ╝хо╣шбицДПцЦЗхнЧшгЬхЕЕ
Ёпж╢	ffypu	ф╕нцЧещЯУхЕ╝хо╣шбицДПцЦЗхнЧшгЬхЕЕ
яен	fhbu	ф╕нцЧещЯУхЕ╝хо╣шбицДПцЦЗхнЧ
ядЦ	fher	ф╕нцЧещЯУхЕ╝хо╣шбицДПцЦЗхнЧ
яжЭ	fhks	ф╕нцЧещЯУхЕ╝хо╣шбицДПцЦЗхнЧ
ЁпдЮ	fhwp	ф╕нцЧещЯУхЕ╝хо╣шбицДПцЦЗхнЧшгЬхЕЕ
т║Ч	fi	ф╕нцЧещЯУщГищжЦшгЬхЕЕ
язА	fkcf	ф╕нцЧещЯУхЕ╝хо╣шбицДПцЦЗхнЧ
язР	fkmbc	ф╕нцЧещЯУхЕ╝хо╣шбицДПцЦЗхнЧ
ЁпдЬ	frse	ф╕нцЧещЯУхЕ╝хо╣шбицДПцЦЗхнЧшгЬхЕЕ
Ёпб┤	fsm	ф╕нцЧещЯУхЕ╝хо╣шбицДПцЦЗхнЧшгЬхЕЕ
ЁпдЩ	ft	ф╕нцЧещЯУхЕ╝хо╣шбицДПцЦЗхнЧшгЬхЕЕ
ЁпаР	fuitc	ф╕нцЧещЯУхЕ╝хо╣шбицДПцЦЗхнЧшгЬхЕЕ
ЁпдЭ	fvmw	ф╕нцЧещЯУхЕ╝хо╣шбицДПцЦЗхнЧшгЬхЕЕ
яд▓	fypt	ф╕нцЧещЯУхЕ╝хо╣шбицДПцЦЗхнЧ
т╝Я	g	х║╖чЖЩщГищжЦ
ЁпбЪ	gbhn	ф╕нцЧещЯУхЕ╝хо╣шбицДПцЦЗхнЧшгЬхЕЕ
яиР	gbmo	ф╕нцЧещЯУхЕ╝хо╣шбицДПцЦЗхнЧ
яй╝	gbmo	ф╕нцЧещЯУхЕ╝хо╣шбицДПцЦЗхнЧ
ЁпбЫ	gbtm	ф╕нцЧещЯУхЕ╝хо╣шбицДПцЦЗхнЧшгЬхЕЕ
яйФ	gdhne	ф╕нцЧещЯУхЕ╝хо╣шбицДПцЦЗхнЧ
ЁпеЩ	gdhne	ф╕нцЧещЯУхЕ╝хо╣шбицДПцЦЗхнЧшгЬхЕЕ
яж╕	gfle	ф╕нцЧещЯУхЕ╝хо╣шбицДПцЦЗхнЧ
ЁпбЩ	ghoc	ф╕нцЧещЯУхЕ╝хо╣шбицДПцЦЗхнЧшгЬхЕЕ
ЁпбТ	gihn	ф╕нцЧещЯУхЕ╝хо╣шбицДПцЦЗхнЧшгЬхЕЕ
ЁпбТ	gihs	ф╕нцЧещЯУхЕ╝хо╣шбицДПцЦЗхнЧшгЬхЕЕ
ЁпбЧ	gjrle	ф╕нцЧещЯУхЕ╝хо╣шбицДПцЦЗхнЧшгЬхЕЕ
яй╜	gjtc	ф╕нцЧещЯУхЕ╝хо╣шбицДПцЦЗхнЧ
т╛Ъ	glnc	х║╖чЖЩщГищжЦ
Ёпг╢	gnhne	ф╕нцЧещЯУхЕ╝хо╣шбицДПцЦЗхнЧшгЬхЕЕ
ЁпзЩ	gofbn	ф╕нцЧещЯУхЕ╝хо╣шбицДПцЦЗхнЧшгЬхЕЕ
ЁпзШ	goomv	ф╕нцЧещЯУхЕ╝хо╣шбицДПцЦЗхнЧшгЬхЕЕ
ЁпзЧ	gosu	ф╕нцЧещЯУхЕ╝хо╣шбицДПцЦЗхнЧшгЬхЕЕ
ялЧ	goyjj	ф╕нцЧещЯУхЕ╝хо╣шбицДПцЦЗхнЧ
ЁпбУ	gpbv	ф╕нцЧещЯУхЕ╝хо╣шбицДПцЦЗхнЧшгЬхЕЕ
яиН	grhne	ф╕нцЧещЯУхЕ╝хо╣шбицДПцЦЗхнЧ
ЁпбР	gsh	ф╕нцЧещЯУхЕ╝хо╣шбицДПцЦЗхнЧшгЬхЕЕ
ЁпбФ	gshi	ф╕нцЧещЯУхЕ╝хо╣шбицДПцЦЗхнЧшгЬхЕЕ
яи╣	gsyj	ф╕нцЧещЯУхЕ╝хо╣шбицДПцЦЗхнЧ
т┐О	gtje	х║╖чЖЩщГищжЦ
т╛Ы	gyo	х║╖чЖЩщГищжЦ
т╝Г	h	х║╖чЖЩщГищжЦ
т╜╡	h	х║╖чЖЩщГищжЦ
уЗТ	h	ф╕нцЧещЯУчнЖчХл
т╜й	ha	х║╖чЖЩщГищжЦ
ЁпиЕ	haabt	ф╕нцЧещЯУхЕ╝хо╣шбицДПцЦЗхнЧшгЬхЕЕ
т╛╣	had	х║╖чЖЩщГищжЦ
Ёпд╗	haikf	ф╕нцЧещЯУхЕ╝хо╣шбицДПцЦЗхнЧшгЬхЕЕ
якн	hail	ф╕нцЧещЯУхЕ╝хо╣шбицДПцЦЗхнЧ
ялЦ	hanj	ф╕нцЧещЯУхЕ╝хо╣шбицДПцЦЗхнЧ
Ёпд╝	hatbf	ф╕нцЧещЯУхЕ╝хо╣шбицДПцЦЗхнЧшгЬхЕЕ
т┐Г	hayf	х║╖чЖЩщГищжЦ
Ёпда	hbddf	ф╕нцЧещЯУхЕ╝хо╣шбицДПцЦЗхнЧшгЬхЕЕ
Ёпеб	hbfd	ф╕нцЧещЯУхЕ╝хо╣шбицДПцЦЗхнЧшгЬхЕЕ
Ёпед	hbhf	ф╕нцЧещЯУхЕ╝хо╣шбицДПцЦЗхнЧшгЬхЕЕ
т╛О	hbt	х║╖чЖЩщГищжЦ
т╛Г	hbu	х║╖чЖЩщГищжЦ
т╛И	hbyi	х║╖чЖЩщГищжЦ
язЗ	hcln	ф╕нцЧещЯУхЕ╝хо╣шбицДПцЦЗхнЧ
т╜▓	hd	х║╖чЖЩщГищжЦ
ЁпеЫ	hdbsp	ф╕нцЧещЯУхЕ╝хо╣шбицДПцЦЗхнЧшгЬхЕЕ
яеЦ	hdgce	ф╕нцЧещЯУхЕ╝хо╣шбицДПцЦЗхнЧ
якД	hdhhh	ф╕нцЧещЯУхЕ╝хо╣шбицДПцЦЗхнЧ
яжХ	hdhj	ф╕нцЧещЯУхЕ╝хо╣шбицДПцЦЗхнЧ
ЁпеЪ	hdhpu	ф╕нцЧещЯУхЕ╝хо╣шбицДПцЦЗхнЧшгЬхЕЕ
ЁпеЧ	hdid	ф╕нцЧещЯУхЕ╝хо╣шбицДПцЦЗхнЧшгЬхЕЕ
язЭ	hdln	ф╕нцЧещЯУхЕ╝хо╣шбицДПцЦЗхнЧ
ЁпеШ	hdmjj	ф╕нцЧещЯУхЕ╝хо╣шбицДПцЦЗхнЧшгЬхЕЕ
т┐Й	hdoe	х║╖чЖЩщГищжЦ
т╝б	he	х║╖чЖЩщГищжЦ
т╝в	he	х║╖чЖЩщГищжЦ
ЁпаЪ	heim	ф╕нцЧещЯУхЕ╝хо╣шбицДПцЦЗхнЧшгЬхЕЕ
ЁпбЬ	heqj	ф╕нцЧещЯУхЕ╝хо╣шбицДПцЦЗхнЧшгЬхЕЕ
яйЙ	hf	ф╕нцЧещЯУхЕ╝хо╣шбицДПцЦЗхнЧ
т║г	hf	ф╕нцЧещЯУщГищжЦшгЬхЕЕ
т║д	hf	ф╕нцЧещЯУщГищжЦшгЬхЕЕ
т║е	hf	ф╕нцЧещЯУщГищжЦшгЬхЕЕ
т╛д	hfd	х║╖чЖЩщГищжЦ
т║з	hg	ф╕нцЧещЯУщГищжЦшгЬхЕЕ
ядЧ	hgher	ф╕нцЧещЯУхЕ╝хо╣шбицДПцЦЗхнЧ
т║Б	hh	ф╕нцЧещЯУщГищжЦшгЬхЕЕ
Ёпа▒	hhapl	ф╕нцЧещЯУхЕ╝хо╣шбицДПцЦЗхнЧшгЬхЕЕ
т╝║	hhh	х║╖чЖЩщГищжЦ
Ёпа▓	hhhil	ф╕нцЧещЯУхЕ╝хо╣шбицДПцЦЗхнЧшгЬхЕЕ
т╛б	hhho	х║╖чЖЩщГищжЦ
Ёпа│	hhhpl	ф╕нцЧещЯУхЕ╝хо╣шбицДПцЦЗхнЧшгЬхЕЕ
Ёпзе	hhisl	ф╕нцЧещЯУхЕ╝хо╣шбицДПцЦЗхнЧшгЬхЕЕ
яжЙ	hhoe	ф╕нцЧещЯУхЕ╝хо╣шбицДПцЦЗхнЧ
яйЦ	hhsl	ф╕нцЧещЯУхЕ╝хо╣шбицДПцЦЗхнЧ
ядЬ	hhsli	ф╕нцЧещЯУхЕ╝хо╣шбицДПцЦЗхнЧ
язН	hhw	ф╕нцЧещЯУхЕ╝хо╣шбицДПцЦЗхнЧ
уЗЫ	hi	ф╕нцЧещЯУчнЖчХл
яжж	hihc	ф╕нцЧещЯУхЕ╝хо╣шбицДПцЦЗхнЧ
Ёпе╣	hjsmm	ф╕нцЧещЯУхЕ╝хо╣шбицДПцЦЗхнЧшгЬхЕЕ
яйА	hkp	ф╕нцЧещЯУхЕ╝хо╣шбицДПцЦЗхнЧ
якЛ	hkp	ф╕нцЧещЯУхЕ╝хо╣шбицДПцЦЗхнЧ
Ёпв░	hkp	ф╕нцЧещЯУхЕ╝хо╣шбицДПцЦЗхнЧшгЬхЕЕ
т║Е	hl	ф╕нцЧещЯУщГищжЦшгЬхЕЕ
ялШ	hlapp	ф╕нцЧещЯУхЕ╝хо╣шбицДПцЦЗхнЧ
ЁпбЦ	hlg	ф╕нцЧещЯУхЕ╝хо╣шбицДПцЦЗхнЧшгЬхЕЕ
т╜Ц	hlo	х║╖чЖЩщГищжЦ
Ёпб╜	hlu	ф╕нцЧещЯУхЕ╝хо╣шбицДПцЦЗхнЧшгЬхЕЕ
т╜Д	hml	х║╖чЖЩщГищжЦ
Ёпег	hmnd	ф╕нцЧещЯУхЕ╝хо╣шбицДПцЦЗхнЧшгЬхЕЕ
т╝П	hn	х║╖чЖЩщГищжЦ
т║З	hn	ф╕нцЧещЯУщГищжЦшгЬхЕЕ
т║И	hn	ф╕нцЧещЯУщГищжЦшгЬхЕЕ
язв	hnd	ф╕нцЧещЯУхЕ╝хо╣шбицДПцЦЗхнЧ
т╜О	hne	х║╖чЖЩщГищжЦ
т╛╡	hnhli	х║╖чЖЩщГищжЦ
ЁпиБ	hnid	ф╕нцЧещЯУхЕ╝хо╣шбицДПцЦЗхнЧшгЬхЕЕ
т╗Ы	hnk	ф╕нцЧещЯУщГищжЦшгЬхЕЕ
т╝Л	ho	х║╖чЖЩщГищжЦ
т╝╗	ho	х║╖чЖЩщГищжЦ
якЕ	hobmu	ф╕нцЧещЯУхЕ╝хо╣шбицДПцЦЗхнЧ
ЁпвЬ	hodw	ф╕нцЧещЯУхЕ╝хо╣шбицДПцЦЗхнЧшгЬхЕЕ
ЁпвЫ	hokoo	ф╕нцЧещЯУхЕ╝хо╣шбицДПцЦЗхнЧшгЬхЕЕ
язШ	holq	ф╕нцЧещЯУхЕ╝хо╣шбицДПцЦЗхнЧ
яиИ	hommn	ф╕нцЧещЯУхЕ╝хо╣шбицДПцЦЗхнЧ
т╛П	hommn	х║╖чЖЩщГищжЦ
Ёпг░	hono	ф╕нцЧещЯУхЕ╝хо╣шбицДПцЦЗхнЧшгЬхЕЕ
яеж	hooae	ф╕нцЧещЯУхЕ╝хо╣шбицДПцЦЗхнЧ
ЁпзГ	hopcn	ф╕нцЧещЯУхЕ╝хо╣шбицДПцЦЗхнЧшгЬхЕЕ
Ёпа┤	hp	ф╕нцЧещЯУхЕ╝хо╣шбицДПцЦЗхнЧшгЬхЕЕ
ЁпгЛ	hpmvu	ф╕нцЧещЯУхЕ╝хо╣шбицДПцЦЗхнЧшгЬхЕЕ
Ёпа░	hpsl	ф╕нцЧещЯУхЕ╝хо╣шбицДПцЦЗхнЧшгЬхЕЕ
т╜Ь	hq	х║╖чЖЩщГищжЦ
т╜г	hqm	х║╖чЖЩщГищжЦ
Ёпде	hqthb	ф╕нцЧещЯУхЕ╝хо╣шбицДПцЦЗхнЧшгЬхЕЕ
т╜С	hqu	х║╖чЖЩщГищжЦ
т╛й	hrj	х║╖чЖЩщГищжЦ
т╗Х	hrlr	ф╕нцЧещЯУщГищжЦшгЬхЕЕ
т╝У	hs	х║╖чЖЩщГищжЦ
т╝╛	hs	х║╖чЖЩщГищжЦ
т║Ж	hs	ф╕нцЧещЯУщГищжЦшгЬхЕЕ
Ёпев	hsmo	ф╕нцЧещЯУхЕ╝хо╣шбицДПцЦЗхнЧшгЬхЕЕ
яйВ	hsmvu	ф╕нцЧещЯУхЕ╝хо╣шбицДПцЦЗхнЧ
Ёпд┐	hubt	ф╕нцЧещЯУхЕ╝хо╣шбицДПцЦЗхнЧшгЬхЕЕ
Ёпез	hufd	ф╕нцЧещЯУхЕ╝хо╣шбицДПцЦЗхнЧшгЬхЕЕ
т┐Б	hui	х║╖чЖЩщГищжЦ
т╗д	hui	ф╕нцЧещЯУщГищжЦшгЬхЕЕ
яйЬ	huik	ф╕нцЧещЯУхЕ╝хо╣шбицДПцЦЗхнЧ
ЁпиЛ	hunwf	ф╕нцЧещЯУхЕ╝хо╣шбицДПцЦЗхнЧшгЬхЕЕ
Ёпе╗	huumb	ф╕нцЧещЯУхЕ╝хо╣шбицДПцЦЗхнЧшгЬхЕЕ
т┐Р	huwml	х║╖чЖЩщГищжЦ
ЁпиЬ	huwt	ф╕нцЧещЯУхЕ╝хо╣шбицДПцЦЗхнЧшгЬхЕЕ
уЗв	hv	ф╕нцЧещЯУчнЖчХл
т╜а	hvio	х║╖чЖЩщГищжЦ
т╜Т	hvp	х║╖чЖЩщГищжЦ
Ёпее	hvvd	ф╕нцЧещЯУхЕ╝хо╣шбицДПцЦЗхнЧшгЬхЕЕ
яи╡	hwhj	ф╕нцЧещЯУхЕ╝хо╣шбицДПцЦЗхнЧ
Ёпан	hwhj	ф╕нцЧещЯУхЕ╝хо╣шбицДПцЦЗхнЧшгЬхЕЕ
т╛Е	hx	х║╖чЖЩщГищжЦ
т║╜	hx	ф╕нцЧещЯУщГищжЦшгЬхЕЕ
т╛Э	hxh	х║╖чЖЩщГищжЦ
ЁпиН	hxhaf	ф╕нцЧещЯУхЕ╝хо╣шбицДПцЦЗхнЧшгЬхЕЕ
ЁпаТ	hxlc	ф╕нцЧещЯУхЕ╝хо╣шбицДПцЦЗхнЧшгЬхЕЕ
ЁпвУ	hxt	ф╕нцЧещЯУхЕ╝хо╣шбицДПцЦЗхнЧшгЬхЕЕ
ЁпжЛ	hxt	ф╕нцЧещЯУхЕ╝хо╣шбицДПцЦЗхнЧшгЬхЕЕ
ядЗ	hxu	ф╕нцЧещЯУхЕ╝хо╣шбицДПцЦЗхнЧ
ялО	hxu	ф╕нцЧещЯУхЕ╝хо╣шбицДПцЦЗхнЧ
т╗▒	hxu	ф╕нцЧещЯУщГищжЦшгЬхЕЕ
ЁпжМ	hxvsf	ф╕нцЧещЯУхЕ╝хо╣шбицДПцЦЗхнЧшгЬхЕЕ
т┐П	hxvyv	х║╖чЖЩщГищжЦ
т║Ц	hy	ф╕нцЧещЯУщГищжЦшгЬхЕЕ
яеД	hybp	ф╕нцЧещЯУхЕ╝хо╣шбицДПцЦЗхнЧ
Ёпеа	hyjj	ф╕нцЧещЯУхЕ╝хо╣шбицДПцЦЗхнЧшгЬхЕЕ
яз╕	hyt	ф╕нцЧещЯУхЕ╝хо╣шбицДПцЦЗхнЧ
ЁпжО	hyyjj	ф╕нцЧещЯУхЕ╝хо╣шбицДПцЦЗхнЧшгЬхЕЕ
т╝В	i	х║╖чЖЩщГищжЦ
т╝╜	i	х║╖чЖЩщГищжЦ
уЗФ	i	ф╕нцЧещЯУчнЖчХл
яе╝	iav	ф╕нцЧещЯУхЕ╝хо╣шбицДПцЦЗхнЧ
т╝з	ib	х║╖чЖЩщГищжЦ
ЁпиС	ichaf	ф╕нцЧещЯУхЕ╝хо╣шбицДПцЦЗхнЧшгЬхЕЕ
ЁпиХ	idd	ф╕нцЧещЯУхЕ╝хо╣шбицДПцЦЗхнЧшгЬхЕЕ
ЁпвП	idhni	ф╕нцЧещЯУхЕ╝хо╣шбицДПцЦЗхнЧшгЬхЕЕ
ЁпгГ	idq	ф╕нцЧещЯУхЕ╝хо╣шбицДПцЦЗхнЧшгЬхЕЕ
яйб	ifbuu	ф╕нцЧещЯУхЕ╝хо╣шбицДПцЦЗхнЧ
як╕	ifbuu	ф╕нцЧещЯУхЕ╝хо╣шбицДПцЦЗхнЧ
ЁпеХ	ifhlw	ф╕нцЧещЯУхЕ╝хо╣шбицДПцЦЗхнЧшгЬхЕЕ
ЁпеТ	ifok	ф╕нцЧещЯУхЕ╝хо╣шбицДПцЦЗхнЧшгЬхЕЕ
ЁпеЦ	ifslw	ф╕нцЧещЯУхЕ╝хо╣шбицДПцЦЗхнЧшгЬхЕЕ
ЁпеФ	ifyhu	ф╕нцЧещЯУхЕ╝хо╣шбицДПцЦЗхнЧшгЬхЕЕ
ЁпеФ	ifyku	ф╕нцЧещЯУхЕ╝хо╣шбицДПцЦЗхнЧшгЬхЕЕ
яжв	ihhc	ф╕нцЧещЯУхЕ╝хо╣шбицДПцЦЗхнЧ
Ёпв▓	ihmn	ф╕нцЧещЯУхЕ╝хо╣шбицДПцЦЗхнЧшгЬхЕЕ
Ёпв▓	ihs	ф╕нцЧещЯУхЕ╝хо╣шбицДПцЦЗхнЧшгЬхЕЕ
ЁпвО	ihvl	ф╕нцЧещЯУхЕ╝хо╣шбицДПцЦЗхнЧшгЬхЕЕ
т║А	ii	ф╕нцЧещЯУщГищжЦшгЬхЕЕ
якТ	iib	ф╕нцЧещЯУхЕ╝хо╣шбицДПцЦЗхнЧ
т║Н	iih	ф╕нцЧещЯУщГищжЦшгЬхЕЕ
яел	iiih	ф╕нцЧещЯУхЕ╝хо╣шбицДПцЦЗхнЧ
т╜з	iim	х║╖чЖЩщГищжЦ
т║б	iim	ф╕нцЧещЯУщГищжЦшгЬхЕЕ
т╗Н	iino	ф╕нцЧещЯУщГищжЦшгЬхЕЕ
яди	iivl	ф╕нцЧещЯУхЕ╝хо╣шбицДПцЦЗхнЧ
т┐З	ijcc	х║╖чЖЩщГищжЦ
ЁпбВ	ijsr	ф╕нцЧещЯУхЕ╝хо╣шбицДПцЦЗхнЧшгЬхЕЕ
т╜Э	ik	х║╖чЖЩщГищжЦ
т╗░	ikp	ф╕нцЧещЯУщГищжЦшгЬхЕЕ
ЁпбГ	ikr	ф╕нцЧещЯУхЕ╝хо╣шбицДПцЦЗхнЧшгЬхЕЕ
ЁпбВ	ilr	ф╕нцЧещЯУхЕ╝хо╣шбицДПцЦЗхнЧшгЬхЕЕ
ЁпвК	ilwp	ф╕нцЧещЯУхЕ╝хо╣шбицДПцЦЗхнЧшгЬхЕЕ
т╝З	im	х║╖чЖЩщГищжЦ
т╝О	im	х║╖чЖЩщГищжЦ
яеХ	imgce	ф╕нцЧещЯУхЕ╝хо╣шбицДПцЦЗхнЧ
Ёпгп	imno	ф╕нцЧещЯУхЕ╝хо╣шбицДПцЦЗхнЧшгЬхЕЕ
ядо	imoml	ф╕нцЧещЯУхЕ╝хо╣шбицДПцЦЗхнЧ
ЁпаЬ	imqbu	ф╕нцЧещЯУхЕ╝хо╣шбицДПцЦЗхнЧшгЬхЕЕ
яе╣	imyrf	ф╕нцЧещЯУхЕ╝хо╣шбицДПцЦЗхнЧ
яеФ	imywd	ф╕нцЧещЯУхЕ╝хо╣шбицДПцЦЗхнЧ
т╝Н	in	х║╖чЖЩщГищжЦ
якз	inbt	ф╕нцЧещЯУхЕ╝хо╣шбицДПцЦЗхнЧ
т║н	inf	ф╕нцЧещЯУщГищжЦшгЬхЕЕ
т╗В	inlo	ф╕нцЧещЯУщГищжЦшгЬхЕЕ
т╗О	inno	ф╕нцЧещЯУщГищжЦшгЬхЕЕ
яйж	ino	ф╕нцЧещЯУхЕ╝хо╣шбицДПцЦЗхнЧ
т╗М	ino	ф╕нцЧещЯУщГищжЦшгЬхЕЕ
т╗В	inol	ф╕нцЧещЯУщГищжЦшгЬхЕЕ
т╗И	inv	ф╕нцЧещЯУщГищжЦшгЬхЕЕ
т╝╖	ip	х║╖чЖЩщГищжЦ
яз│	ipfdq	ф╕нцЧещЯУхЕ╝хо╣шбицДПцЦЗхнЧ
ЁпиФ	ipmjj	ф╕нцЧещЯУхЕ╝хо╣шбицДПцЦЗхнЧшгЬхЕЕ
якВ	iqsk	ф╕нцЧещЯУхЕ╝хо╣шбицДПцЦЗхнЧ
яиБ	ite	ф╕нцЧещЯУхЕ╝хо╣шбицДПцЦЗхнЧ
ЁпвН	itf	ф╕нцЧещЯУхЕ╝хо╣шбицДПцЦЗхнЧшгЬхЕЕ
яиХ	iuf	ф╕нцЧещЯУхЕ╝хо╣шбицДПцЦЗхнЧ
ядй	ivb	ф╕нцЧещЯУхЕ╝хо╣шбицДПцЦЗхнЧ
ЁпгШ	ivb	ф╕нцЧещЯУхЕ╝хо╣шбицДПцЦЗхнЧшгЬхЕЕ
Ёпаб	ivln	ф╕нцЧещЯУхЕ╝хо╣шбицДПцЦЗхнЧшгЬхЕЕ
ядм	ivnl	ф╕нцЧещЯУхЕ╝хо╣шбицДПцЦЗхнЧ
ЁпвМ	iwlj	ф╕нцЧещЯУхЕ╝хо╣шбицДПцЦЗхнЧшгЬхЕЕ
яйл	iwp	ф╕нцЧещЯУхЕ╝хо╣шбицДПцЦЗхнЧ
якГ	iwtc	ф╕нцЧещЯУхЕ╝хо╣шбицДПцЦЗхнЧ
яеА	ixp	ф╕нцЧещЯУхЕ╝хо╣шбицДПцЦЗхнЧ
т┐Е	ixp	х║╖чЖЩщГищжЦ
яиЛ	iydl	ф╕нцЧещЯУхЕ╝хо╣шбицДПцЦЗхнЧ
ЁпвЛ	iyjj	ф╕нцЧещЯУхЕ╝хо╣шбицДПцЦЗхнЧшгЬхЕЕ
яжВ	iypt	ф╕нцЧещЯУхЕ╝хо╣шбицДПцЦЗхнЧ
т╝Ч	j	х║╖чЖЩщГищжЦ
яйИ	jaf	ф╕нцЧещЯУхЕ╝хо╣шбицДПцЦЗхнЧ
якЬ	jaf	ф╕нцЧещЯУхЕ╝хо╣шбицДПцЦЗхнЧ
яиж	janl	ф╕нцЧещЯУхЕ╝хо╣шбицДПцЦЗхнЧ
яки	jbmm	ф╕нцЧещЯУхЕ╝хо╣шбицДПцЦЗхнЧ
Ёпз╗	jbmom	ф╕нцЧещЯУхЕ╝хо╣шбицДПцЦЗхнЧшгЬхЕЕ
ЁпеЗ	jbuc	ф╕нцЧещЯУхЕ╝хо╣шбицДПцЦЗхнЧшгЬхЕЕ
ЁпеА	jbuv	ф╕нцЧещЯУхЕ╝хо╣шбицДПцЦЗхнЧшгЬхЕЕ
яек	jbvif	ф╕нцЧещЯУхЕ╝хо╣шбицДПцЦЗхнЧ
т╜│	jc	х║╖чЖЩщГищжЦ
яйХ	jcik	ф╕нцЧещЯУхЕ╝хо╣шбицДПцЦЗхнЧ
ЁпеЬ	jcjbt	ф╕нцЧещЯУхЕ╝хо╣шбицДПцЦЗхнЧшгЬхЕЕ
якм	jcold	ф╕нцЧещЯУхЕ╝хо╣шбицДПцЦЗхнЧ
т╜А	je	х║╖чЖЩщГищжЦ
яин	jghaf	ф╕нцЧещЯУхЕ╝хо╣шбицДПцЦЗхнЧ
яиД	jhp	ф╕нцЧещЯУхЕ╝хо╣шбицДПцЦЗхнЧ
яеЖ	jhq	ф╕нцЧещЯУхЕ╝хо╣шбицДПцЦЗхнЧ
Ёпао	jiji	ф╕нцЧещЯУхЕ╝хо╣шбицДПцЦЗхнЧшгЬхЕЕ
якМ	jiwtc	ф╕нцЧещЯУхЕ╝хо╣шбицДПцЦЗхнЧ
яйЮ	jj	ф╕нцЧещЯУхЕ╝хо╣шбицДПцЦЗхнЧ
ЁпвР	jj	ф╕нцЧещЯУхЕ╝хо╣шбицДПцЦЗхнЧшгЬхЕЕ
т╝╢	jj	х║╖чЖЩщГищжЦ
т║╛	jj	ф╕нцЧещЯУщГищжЦшгЬхЕЕ
т║┐	jj	ф╕нцЧещЯУщГищжЦшгЬхЕЕ
яиЗ	jjmrw	ф╕нцЧещЯУхЕ╝хо╣шбицДПцЦЗхнЧ
язЧ	jjomb	ф╕нцЧещЯУхЕ╝хо╣шбицДПцЦЗхнЧ
ялВ	jjomn	ф╕нцЧещЯУхЕ╝хо╣шбицДПцЦЗхнЧ
ЁпзЯ	jjomv	ф╕нцЧещЯУхЕ╝хо╣шбицДПцЦЗхнЧшгЬхЕЕ
ЁпзЮ	jjsk	ф╕нцЧещЯУхЕ╝хо╣шбицДПцЦЗхнЧшгЬхЕЕ
яжН	jjvid	ф╕нцЧещЯУхЕ╝хо╣шбицДПцЦЗхнЧ
т║╣	jk	ф╕нцЧещЯУщГищжЦшгЬхЕЕ
як▓	jka	ф╕нцЧещЯУхЕ╝хо╣шбицДПцЦЗхнЧ
яж╝	jkcf	ф╕нцЧещЯУхЕ╝хо╣шбицДПцЦЗхнЧ
яйЫ	jkia	ф╕нцЧещЯУхЕ╝хо╣шбицДПцЦЗхнЧ
Ёпе║	jkia	ф╕нцЧещЯУхЕ╝хо╣шбицДПцЦЗхнЧшгЬхЕЕ
яд┤	jkp	ф╕нцЧещЯУхЕ╝хо╣шбицДПцЦЗхнЧ
т╜╝	jkp	х║╖чЖЩщГищжЦ
язЮ	jlk	ф╕нцЧещЯУхЕ╝хо╣шбицДПцЦЗхнЧ
т╝а	jm	х║╖чЖЩщГищжЦ
Ёпб░	jmfc	ф╕нцЧещЯУхЕ╝хо╣шбицДПцЦЗхнЧшгЬхЕЕ
яйд	jmhc	ф╕нцЧещЯУхЕ╝хо╣шбицДПцЦЗхнЧ
Ёпбм	jmms	ф╕нцЧещЯУхЕ╝хо╣шбицДПцЦЗхнЧшгЬхЕЕ
т┐Ж	joni	х║╖чЖЩщГищжЦ
Ёпбо	jpbc	ф╕нцЧещЯУхЕ╝хо╣шбицДПцЦЗхнЧшгЬхЕЕ
яеЯ	jpbn	ф╕нцЧещЯУхЕ╝хо╣шбицДПцЦЗхнЧ
яжк	jpbn	ф╕нцЧещЯУхЕ╝хо╣шбицДПцЦЗхнЧ
Ёпбп	jpwn	ф╕нцЧещЯУхЕ╝хо╣шбицДПцЦЗхнЧшгЬхЕЕ
Ёпвм	jqjp	ф╕нцЧещЯУхЕ╝хо╣шбицДПцЦЗхнЧшгЬхЕЕ
Ёпав	jrln	ф╕нцЧещЯУхЕ╝хо╣шбицДПцЦЗхнЧшгЬхЕЕ
т║║	js	ф╕нцЧещЯУщГищжЦшгЬхЕЕ
Ёпбн	jshi	ф╕нцЧещЯУхЕ╝хо╣шбицДПцЦЗхнЧшгЬхЕЕ
Ёпам	jt	ф╕нцЧещЯУхЕ╝хо╣шбицДПцЦЗхнЧшгЬхЕЕ
ЁпзХ	jtbc	ф╕нцЧещЯУхЕ╝хо╣шбицДПцЦЗхнЧшгЬхЕЕ
яем	jtcg	ф╕нцЧещЯУхЕ╝хо╣шбицДПцЦЗхнЧ
Ёпгб	jtd	ф╕нцЧещЯУхЕ╝хо╣шбицДПцЦЗхнЧшгЬхЕЕ
ЁпиЫ	jtge	ф╕нцЧещЯУхЕ╝хо╣шбицДПцЦЗхнЧшгЬхЕЕ
ЁпеЖ	jumc	ф╕нцЧещЯУхЕ╝хо╣шбицДПцЦЗхнЧшгЬхЕЕ
ядВ	jwj	ф╕нцЧещЯУхЕ╝хо╣шбицДПцЦЗхнЧ
т╛Ю	jwj	х║╖чЖЩщГищжЦ
т╝д	k	х║╖чЖЩщГищжЦ
яке	kabt	ф╕нцЧещЯУхЕ╝хо╣шбицДПцЦЗхнЧ
Ёпг╡	kchne	ф╕нцЧещЯУхЕ╝хо╣шбицДПцЦЗхнЧшгЬхЕЕ
Ёпз░	kdano	ф╕нцЧещЯУхЕ╝хо╣шбицДПцЦЗхнЧшгЬхЕЕ
яе░	kdhne	ф╕нцЧещЯУхЕ╝хо╣шбицДПцЦЗхнЧ
якЦ	kdhne	ф╕нцЧещЯУхЕ╝хо╣шбицДПцЦЗхнЧ
ядО	kdlc	ф╕нцЧещЯУхЕ╝хо╣шбицДПцЦЗхнЧ
ЁпиТ	kehaf	ф╕нцЧещЯУхЕ╝хо╣шбицДПцЦЗхнЧшгЬхЕЕ
Ёпди	khdlc	ф╕нцЧещЯУхЕ╝хо╣шбицДПцЦЗхнЧшгЬхЕЕ
язе	khdn	ф╕нцЧещЯУхЕ╝хо╣шбицДПцЦЗхнЧ
ядл	khiav	ф╕нцЧещЯУхЕ╝хо╣шбицДПцЦЗхнЧ
Ёпдз	khibc	ф╕нцЧещЯУхЕ╝хо╣шбицДПцЦЗхнЧшгЬхЕЕ
яиЦ	khjka	ф╕нцЧещЯУхЕ╝хо╣шбицДПцЦЗхнЧ
яка	khjka	ф╕нцЧещЯУхЕ╝хо╣шбицДПцЦЗхнЧ
Ёпдж	khmjj	ф╕нцЧещЯУхЕ╝хо╣шбицДПцЦЗхнЧшгЬхЕЕ
якЯ	khru	ф╕нцЧещЯУхЕ╝хо╣шбицДПцЦЗхнЧ
яжз	khvvv	ф╕нцЧещЯУхЕ╝хо╣шбицДПцЦЗхнЧ
т╝╢	kj	х║╖чЖЩщГищжЦ
ЁпбЯ	kjka	ф╕нцЧещЯУхЕ╝хо╣шбицДПцЦЗхнЧшгЬхЕЕ
яй┐	kjt	ф╕нцЧещЯУхЕ╝хо╣шбицДПцЦЗхнЧ
т╜Ш	kk	х║╖чЖЩщГищжЦ
язБ	kkcf	ф╕нцЧещЯУхЕ╝хо╣шбицДПцЦЗхнЧ
Ёпд║	klwo	ф╕нцЧещЯУхЕ╝хо╣шбицДПцЦЗхнЧшгЬхЕЕ
ядМ	kmmf	ф╕нцЧещЯУхЕ╝хо╣шбицДПцЦЗхнЧ
уН╜	kmym	ф╕нцЧещЯУхЕ╝хо╣чмжшЩЯ
т║и	knh	ф╕нцЧещЯУщГищжЦшгЬхЕЕ
ЁпаБ	knk	ф╕нцЧещЯУхЕ╝хо╣шбицДПцЦЗхнЧшгЬхЕЕ
т╗Л	kq	ф╕нцЧещЯУщГищжЦшгЬхЕЕ
яжК	ks	ф╕нцЧещЯУхЕ╝хо╣шбицДПцЦЗхнЧ
т╝Т	ks	х║╖чЖЩщГищжЦ
т║и	ksh	ф╕нцЧещЯУщГищжЦшгЬхЕЕ
Ёпб╡	ku	ф╕нцЧещЯУхЕ╝хо╣шбицДПцЦЗхнЧшгЬхЕЕ
т╝к	ku	х║╖чЖЩщГищжЦ
т║Р	ku	ф╕нцЧещЯУщГищжЦшгЬхЕЕ
Ёпб╢	kuap	ф╕нцЧещЯУхЕ╝хо╣шбицДПцЦЗхнЧшгЬхЕЕ
якд	kwle	ф╕нцЧещЯУхЕ╝хо╣шбицДПцЦЗхнЧ
яй╛	kwu	ф╕нцЧещЯУхЕ╝хо╣шбицДПцЦЗхнЧ
т╝Б	l	х║╖чЖЩщГищжЦ
уЗС	l	ф╕нцЧещЯУчнЖчХл
уЗУ	l	ф╕нцЧещЯУчнЖчХл
яйа	lapv	ф╕нцЧещЯУхЕ╝хо╣шбицДПцЦЗхнЧ
т╝▒	lb	х║╖чЖЩщГищжЦ
ЁпвЖ	lbabu	ф╕нцЧещЯУхЕ╝хо╣шбицДПцЦЗхнЧшгЬхЕЕ
ЁпвИ	lbaws	ф╕нцЧещЯУхЕ╝хо╣шбицДПцЦЗхнЧшгЬхЕЕ
ЁпвЕ	lbcru	ф╕нцЧещЯУхЕ╝хо╣шбицДПцЦЗхнЧшгЬхЕЕ
ЁпвЗ	lbjtc	ф╕нцЧещЯУхЕ╝хо╣шбицДПцЦЗхнЧшгЬхЕЕ
т╜▒	lbmi	х║╖чЖЩщГищжЦ
ЁпвЙ	lbtye	ф╕нцЧещЯУхЕ╝хо╣шбицДПцЦЗхнЧшгЬхЕЕ
т║М	lc	ф╕нцЧещЯУщГищжЦшгЬхЕЕ
ЁпзЗ	lcru	ф╕нцЧещЯУхЕ╝хо╣шбицДПцЦЗхнЧшгЬхЕЕ
ядН	ldlc	ф╕нцЧещЯУхЕ╝хо╣шбицДПцЦЗхнЧ
т╛к	le	х║╖чЖЩщГищжЦ
ЁпгМ	lga	ф╕нцЧещЯУхЕ╝хо╣шбицДПцЦЗхнЧшгЬхЕЕ
Ёпж╗	liabt	ф╕нцЧещЯУхЕ╝хо╣шбицДПцЦЗхнЧшгЬхЕЕ
ЁпзА	libhf	ф╕нцЧещЯУхЕ╝хо╣шбицДПцЦЗхнЧшгЬхЕЕ
Ёпж┐	lihmj	ф╕нцЧещЯУхЕ╝хо╣шбицДПцЦЗхнЧшгЬхЕЕ
Ёпж╣	liib	ф╕нцЧещЯУхЕ╝хо╣шбицДПцЦЗхнЧшгЬхЕЕ
Ёпж╜	lijka	ф╕нцЧещЯУхЕ╝хо╣шбицДПцЦЗхнЧшгЬхЕЕ
т║ж	lim	ф╕нцЧещЯУщГищжЦшгЬхЕЕ
Ёпж╕	limjj	ф╕нцЧещЯУхЕ╝хо╣шбицДПцЦЗхнЧшгЬхЕЕ
т╗Ф	lis	ф╕нцЧещЯУщГищжЦшгЬхЕЕ
Ёпж╛	litvi	ф╕нцЧещЯУхЕ╝хо╣шбицДПцЦЗхнЧшгЬхЕЕ
ЁпзВ	litvp	ф╕нцЧещЯУхЕ╝хо╣шбицДПцЦЗхнЧшгЬхЕЕ
ядз	livvv	ф╕нцЧещЯУхЕ╝хо╣шбицДПцЦЗхнЧ
як╡	liwot	ф╕нцЧещЯУхЕ╝хо╣шбицДПцЦЗхнЧ
ядС	liwvf	ф╕нцЧещЯУхЕ╝хо╣шбицДПцЦЗхнЧ
Ёпж║	liyjj	ф╕нцЧещЯУхЕ╝хо╣шбицДПцЦЗхнЧшгЬхЕЕ
Ёпж╝	liyso	ф╕нцЧещЯУхЕ╝хо╣шбицДПцЦЗхнЧшгЬхЕЕ
ЁпзЙ	lkhu	ф╕нцЧещЯУхЕ╝хо╣шбицДПцЦЗхнЧшгЬхЕЕ
ядЕ	ll	ф╕нцЧещЯУхЕ╝хо╣шбицДПцЦЗхнЧ
Ёпдв	llhjl	ф╕нцЧещЯУхЕ╝хо╣шбицДПцЦЗхнЧшгЬхЕЕ
т╜Ъ	llml	х║╖чЖЩщГищжЦ
т╜Ъ	llmn	х║╖чЖЩщГищжЦ
т║К	lm	ф╕нцЧещЯУщГищжЦшгЬхЕЕ
т║╗	lm	ф╕нцЧещЯУщГищжЦшгЬхЕЕ
уЗД	lm	ф╕нцЧещЯУчнЖчХл
уЗЧ	lm	ф╕нцЧещЯУчнЖчХл
уЗШ	lm	ф╕нцЧещЯУчнЖчХл
Ёпб│	lmbdi	ф╕нцЧещЯУхЕ╝хо╣шбицДПцЦЗхнЧшгЬхЕЕ
ЁпбС	lmg	ф╕нцЧещЯУхЕ╝хо╣шбицДПцЦЗхнЧшгЬхЕЕ
т╛Н	lmi	х║╖чЖЩщГищжЦ
яег	lmp	ф╕нцЧещЯУхЕ╝хо╣шбицДПцЦЗхнЧ
Ёпал	lmp	ф╕нцЧещЯУхЕ╝хо╣шбицДПцЦЗхнЧшгЬхЕЕ
т╛о	lmsy	х║╖чЖЩщГищжЦ
ЁпзЕ	lmt	ф╕нцЧещЯУхЕ╝хо╣шбицДПцЦЗхнЧшгЬхЕЕ
яйЭ	lmy	ф╕нцЧещЯУхЕ╝хо╣шбицДПцЦЗхнЧ
т╗А	lmy	ф╕нцЧещЯУщГищжЦшгЬхЕЕ
т╝Н	ln	х║╖чЖЩщГищжЦ
т╛╛	ln	х║╖чЖЩщГищжЦ
т║Й	ln	ф╕нцЧещЯУщГищжЦшгЬхЕЕ
уЗБ	ln	ф╕нцЧещЯУчнЖчХл
як╢	lnii	ф╕нцЧещЯУхЕ╝хо╣шбицДПцЦЗхнЧ
яй╡	lpwtc	ф╕нцЧещЯУхЕ╝хо╣шбицДПцЦЗхнЧ
т╛А	lq	х║╖чЖЩщГищжЦ
т╝М	ls	х║╖чЖЩщГищжЦ
т║Ж	ls	ф╕нцЧещЯУщГищжЦшгЬхЕЕ
ЁпзИ	lsme	ф╕нцЧещЯУхЕ╝хо╣шбицДПцЦЗхнЧшгЬхЕЕ
т╛▓	lsmm	х║╖чЖЩщГищжЦ
ядд	lsmt	ф╕нцЧещЯУхЕ╝хо╣шбицДПцЦЗхнЧ
ЁпвГ	lss	ф╕нцЧещЯУхЕ╝хо╣шбицДПцЦЗхнЧшгЬхЕЕ
т╝Й	lu	х║╖чЖЩщГищжЦ
уЗВ	lv	ф╕нцЧещЯУчнЖчХл
яей	lvok	ф╕нцЧещЯУхЕ╝хо╣шбицДПцЦЗхнЧ
ядТ	lwd	ф╕нцЧещЯУхЕ╝хо╣шбицДПцЦЗхнЧ
язи	lwg	ф╕нцЧещЯУхЕ╝хо╣шбицДПцЦЗхнЧ
Ёпа╖	lwle	ф╕нцЧещЯУхЕ╝хо╣шбицДПцЦЗхнЧшгЬхЕЕ
Ёпд╡	lwll	ф╕нцЧещЯУхЕ╝хо╣шбицДПцЦЗхнЧшгЬхЕЕ
Ёпд╣	lwyjj	ф╕нцЧещЯУхЕ╝хо╣шбицДПцЦЗхнЧшгЬхЕЕ
ЁпзЖ	lyiv	ф╕нцЧещЯУхЕ╝хо╣шбицДПцЦЗхнЧшгЬхЕЕ
т╝А	m	х║╖чЖЩщГищжЦ
уЗА	m	ф╕нцЧещЯУчнЖчХл
уЗР	m	ф╕нцЧещЯУчнЖчХл
ЁЭН▓	m	чоЧч▒МцХ╕хнЧ
Ёпзд	manl	ф╕нцЧещЯУхЕ╝хо╣шбицДПцЦЗхнЧшгЬхЕЕ
Ёпз╢	mbett	ф╕нцЧещЯУхЕ╝хо╣шбицДПцЦЗхнЧшгЬхЕЕ
як╖	mbhoe	ф╕нцЧещЯУхЕ╝хо╣шбицДПцЦЗхнЧ
Ёпз╡	mbibc	ф╕нцЧещЯУхЕ╝хо╣шбицДПцЦЗхнЧшгЬхЕЕ
яе┐	mbks	ф╕нцЧещЯУхЕ╝хо╣шбицДПцЦЗхнЧ
т╜╜	mbll	х║╖чЖЩщГищжЦ
т╗Ъ	mbo	ф╕нцЧещЯУщГищжЦшгЬхЕЕ
яж▓	mboml	ф╕нцЧещЯУхЕ╝хо╣шбицДПцЦЗхнЧ
яд╕	mbrmr	ф╕нцЧещЯУхЕ╝хо╣шбицДПцЦЗхнЧ
яж│	mbrro	ф╕нцЧещЯУхЕ╝хо╣шбицДПцЦЗхнЧ
т╛┤	mbuc	х║╖чЖЩщГищжЦ
ЁпаГ	mbvm	ф╕нцЧещЯУхЕ╝хо╣шбицДПцЦЗхнЧшгЬхЕЕ
яеЙ	mbw	ф╕нцЧещЯУхЕ╝хо╣шбицДПцЦЗхнЧ
т╗Д	mcw	ф╕нцЧещЯУщГищжЦшгЬхЕЕ
т╛г	mcwm	х║╖чЖЩщГищжЦ
яез	mf	ф╕нцЧещЯУхЕ╝хо╣шбицДПцЦЗхнЧ
Ёпа╡	mf	ф╕нцЧещЯУхЕ╝хо╣шбицДПцЦЗхнЧшгЬхЕЕ
яйТ	mfbbr	ф╕нцЧещЯУхЕ╝хо╣шбицДПцЦЗхнЧ
яйР	mfbm	ф╕нцЧещЯУхЕ╝хо╣шбицДПцЦЗхнЧ
ЁпеУ	mfbm	ф╕нцЧещЯУхЕ╝хо╣шбицДПцЦЗхнЧшгЬхЕЕ
яйб	mfbuu	ф╕нцЧещЯУхЕ╝хо╣шбицДПцЦЗхнЧ
яйМ	mfg	ф╕нцЧещЯУхЕ╝хо╣шбицДПцЦЗхнЧ
яйО	mfhml	ф╕нцЧещЯУхЕ╝хо╣шбицДПцЦЗхнЧ
яйП	mfkr	ф╕нцЧещЯУхЕ╝хо╣шбицДПцЦЗхнЧ
яиЩ	mflwl	ф╕нцЧещЯУхЕ╝хо╣шбицДПцЦЗхнЧ
яиЫ	mfmrw	ф╕нцЧещЯУхЕ╝хо╣шбицДПцЦЗхнЧ
яйС	mfrhu	ф╕нцЧещЯУхЕ╝хо╣шбицДПцЦЗхнЧ
яиЪ	mftq	ф╕нцЧещЯУхЕ╝хо╣шбицДПцЦЗхнЧ
яж╢	mftwt	ф╕нцЧещЯУхЕ╝хо╣шбицДПцЦЗхнЧ
яиШ	mfu	ф╕нцЧещЯУхЕ╝хо╣шбицДПцЦЗхнЧ
яд╝	mfvne	ф╕нцЧещЯУхЕ╝хо╣шбицДПцЦЗхнЧ
яйУ	mfybc	ф╕нцЧещЯУхЕ╝хо╣шбицДПцЦЗхнЧ
яйН	mfylm	ф╕нцЧещЯУхЕ╝хо╣шбицДПцЦЗхнЧ
Ёпдй	mg	ф╕нцЧещЯУхЕ╝хо╣шбицДПцЦЗхнЧшгЬхЕЕ
т║й	mg	ф╕нцЧещЯУщГищжЦшгЬхЕЕ
ЁпаХ	mgb	ф╕нцЧещЯУхЕ╝хо╣шбицДПцЦЗхнЧшгЬхЕЕ
Ёпдл	mgb	ф╕нцЧещЯУхЕ╝хо╣шбицДПцЦЗхнЧшгЬхЕЕ
язп	mgfdq	ф╕нцЧещЯУхЕ╝хо╣шбицДПцЦЗхнЧ
Ёпдк	mghni	ф╕нцЧещЯУхЕ╝хо╣шбицДПцЦЗхнЧшгЬхЕЕ
т╜Я	mgi	х║╖чЖЩщГищжЦ
якб	mgjbc	ф╕нцЧещЯУхЕ╝хо╣шбицДПцЦЗхнЧ
яйК	mgmso	ф╕нцЧещЯУхЕ╝хо╣шбицДПцЦЗхнЧ
Ёпд▓	mgnwe	ф╕нцЧещЯУхЕ╝хо╣шбицДПцЦЗхнЧшгЬхЕЕ
яжн	mgoml	ф╕нцЧещЯУхЕ╝хо╣шбицДПцЦЗхнЧ
Ёпдп	mgomv	ф╕нцЧещЯУхЕ╝хо╣шбицДПцЦЗхнЧшгЬхЕЕ
Ёпд░	mgpbc	ф╕нцЧещЯУхЕ╝хо╣шбицДПцЦЗхнЧшгЬхЕЕ
Ёпдо	mgqmh	ф╕нцЧещЯУхЕ╝хо╣шбицДПцЦЗхнЧшгЬхЕЕ
яеГ	mgt	ф╕нцЧещЯУхЕ╝хо╣шбицДПцЦЗхнЧ
Ёпд▒	mgvvd	ф╕нцЧещЯУхЕ╝хо╣шбицДПцЦЗхнЧшгЬхЕЕ
язд	mgwg	ф╕нцЧещЯУхЕ╝хо╣шбицДПцЦЗхнЧ
язМ	mgyiu	ф╕нцЧещЯУхЕ╝хо╣шбицДПцЦЗхнЧ
яжФ	mgyjj	ф╕нцЧещЯУхЕ╝хо╣шбицДПцЦЗхнЧ
т╝Ъ	mh	х║╖чЖЩщГищжЦ
т║В	mh	ф╕нцЧещЯУщГищжЦшгЬхЕЕ
уЗЗ	mh	ф╕нцЧещЯУчнЖчХл
уЗЦ	mh	ф╕нцЧещЯУчнЖчХл
яжЛ	mhda	ф╕нцЧещЯУхЕ╝хо╣шбицДПцЦЗхнЧ
яжМ	mhdm	ф╕нцЧещЯУхЕ╝хо╣шбицДПцЦЗхнЧ
Ёпдг	mhhx	ф╕нцЧещЯУхЕ╝хо╣шбицДПцЦЗхнЧшгЬхЕЕ
т╛Д	mig	х║╖чЖЩщГищжЦ
ЁпеМ	mir	ф╕нцЧещЯУхЕ╝хо╣шбицДПцЦЗхнЧшгЬхЕЕ
т╝▓	mj	х║╖чЖЩщГищжЦ
Ёпд╛	mjbt	ф╕нцЧещЯУхЕ╝хо╣шбицДПцЦЗхнЧшгЬхЕЕ
уН╗	mjihs	ф╕нцЧещЯУхЕ╝хо╣чмжшЩЯ
ЁпиМ	mjmjf	ф╕нцЧещЯУхЕ╝хо╣шбицДПцЦЗхнЧшгЬхЕЕ
Ёпз│	mjmjg	ф╕нцЧещЯУхЕ╝хо╣шбицДПцЦЗхнЧшгЬхЕЕ
ЁпвЩ	mjmjh	ф╕нцЧещЯУхЕ╝хо╣шбицДПцЦЗхнЧшгЬхЕЕ
Ёпд│	mjmjn	ф╕нцЧещЯУхЕ╝хо╣шбицДПцЦЗхнЧшгЬхЕЕ
ЁпгА	mjq	ф╕нцЧещЯУхЕ╝хо╣шбицДПцЦЗхнЧшгЬхЕЕ
т╛Ж	mjr	х║╖чЖЩщГищжЦ
т╜Ж	mku	х║╖чЖЩщГищжЦ
уЗХ	ml	ф╕нцЧещЯУчнЖчХл
ЁЭН│	ml	чоЧч▒МцХ╕хнЧ
яе╕	mlbo	ф╕нцЧещЯУхЕ╝хо╣шбицДПцЦЗхнЧ
т╛м	mlby	х║╖чЖЩщГищжЦ
т╗Ч	mlby	ф╕нцЧещЯУщГищжЦшгЬхЕЕ
т╗Г	mllw	ф╕нцЧещЯУщГищжЦшгЬхЕЕ
т╝п	mlm	х║╖чЖЩщГищжЦ
якг	mluw	ф╕нцЧещЯУхЕ╝хо╣шбицДПцЦЗхнЧ
ядБ	mlwk	ф╕нцЧещЯУхЕ╝хо╣шбицДПцЦЗхнЧ
т╝Ж	mm	х║╖чЖЩщГищжЦ
ЁпгН	mma	ф╕нцЧещЯУхЕ╝хо╣шбицДПцЦЗхнЧшгЬхЕЕ
яжИ	mmbbp	ф╕нцЧещЯУхЕ╝хо╣шбицДПцЦЗхнЧ
ЁпаА	mmbmb	ф╕нцЧещЯУхЕ╝хо╣шбицДПцЦЗхнЧшгЬхЕЕ
т╜░	mmf	х║╖чЖЩщГищжЦ
т║м	mmf	ф╕нцЧещЯУщГищжЦшгЬхЕЕ
Ёпв│	mmi	ф╕нцЧещЯУхЕ╝хо╣шбицДПцЦЗхнЧшгЬхЕЕ
яе▒	mmmo	ф╕нцЧещЯУхЕ╝хо╣шбицДПцЦЗхнЧ
т╛а	mmmv	х║╖чЖЩщГищжЦ
яж╣	mmp	ф╕нцЧещЯУхЕ╝хо╣шбицДПцЦЗхнЧ
яй▒	mmrhu	ф╕нцЧещЯУхЕ╝хо╣шбицДПцЦЗхнЧ
ЁпаЫ	mmrhu	ф╕нцЧещЯУхЕ╝хо╣шбицДПцЦЗхнЧшгЬхЕЕ
Ёпд╜	mmst	ф╕нцЧещЯУхЕ╝хо╣шбицДПцЦЗхнЧшгЬхЕЕ
Ёпг┤	mnabt	ф╕нцЧещЯУхЕ╝хо╣шбицДПцЦЗхнЧшгЬхЕЕ
яжЯ	mnf	ф╕нцЧещЯУхЕ╝хо╣шбицДПцЦЗхнЧ
ЁпбХ	mng	ф╕нцЧещЯУхЕ╝хо╣шбицДПцЦЗхнЧшгЬхЕЕ
якХ	mni	ф╕нцЧещЯУхЕ╝хо╣шбицДПцЦЗхнЧ
т╜Н	mni	х║╖чЖЩщГищжЦ
яжЬ	mnln	ф╕нцЧещЯУхЕ╝хо╣шбицДПцЦЗхнЧ
яже	mnomo	ф╕нцЧещЯУхЕ╝хо╣шбицДПцЦЗхнЧ
яжа	mnyhv	ф╕нцЧещЯУхЕ╝хо╣шбицДПцЦЗхнЧ
ЁпаВ	mo	ф╕нцЧещЯУхЕ╝хо╣шбицДПцЦЗхнЧшгЬхЕЕ
уЗЭ	mo	ф╕нцЧещЯУчнЖчХл
Ёпд┤	mohqm	ф╕нцЧещЯУхЕ╝хо╣шбицДПцЦЗхнЧшгЬхЕЕ
ЁпзЛ	mpbuu	ф╕нцЧещЯУхЕ╝хо╣шбицДПцЦЗхнЧшгЬхЕЕ
т╜п	mr	х║╖чЖЩщГищжЦ
ЁпеС	mrbhf	ф╕нцЧещЯУхЕ╝хо╣шбицДПцЦЗхнЧшгЬхЕЕ
т┐А	mrbl	х║╖чЖЩщГищжЦ
яед	mrhdw	ф╕нцЧещЯУхЕ╝хо╣шбицДПцЦЗхнЧ
яйЛ	mrhwj	ф╕нцЧещЯУхЕ╝хо╣шбицДПцЦЗхнЧ
якл	mrjbc	ф╕нцЧещЯУхЕ╝хо╣шбицДПцЦЗхнЧ
ЁпеР	mrjbc	ф╕нцЧещЯУхЕ╝хо╣шбицДПцЦЗхнЧшгЬхЕЕ
ЁпеО	mrmjn	ф╕нцЧещЯУхЕ╝хо╣шбицДПцЦЗхнЧшгЬхЕЕ
яеЗ	mrmrr	ф╕нцЧещЯУхЕ╝хо╣шбицДПцЦЗхнЧ
яжЕ	mrmtb	ф╕нцЧещЯУхЕ╝хо╣шбицДПцЦЗхнЧ
ЁпеП	mrnme	ф╕нцЧещЯУхЕ╝хо╣шбицДПцЦЗхнЧшгЬхЕЕ
ЁпеН	mrpm	ф╕нцЧещЯУхЕ╝хо╣шбицДПцЦЗхнЧшгЬхЕЕ
т╛Ц	mrt	х║╖чЖЩщГищжЦ
яд╗	mrvne	ф╕нцЧещЯУхЕ╝хо╣шбицДПцЦЗхнЧ
язО	mryiu	ф╕нцЧещЯУхЕ╝хо╣шбицДПцЦЗхнЧ
ЁпжН	mrytj	ф╕нцЧещЯУхЕ╝хо╣шбицДПцЦЗхнЧшгЬхЕЕ
т╛Ч	msho	х║╖чЖЩщГищжЦ
Ёпз╜	mtmbc	ф╕нцЧещЯУхЕ╝хо╣шбицДПцЦЗхнЧшгЬхЕЕ
яиМ	mu	ф╕нцЧещЯУхЕ╝хо╣шбицДПцЦЗхнЧ
т║О	mu	ф╕нцЧещЯУщГищжЦшгЬхЕЕ
т╛С	mub	х║╖чЖЩщГищжЦ
ялЛ	mumbc	ф╕нцЧещЯУхЕ╝хо╣шбицДПцЦЗхнЧ
Ёпз╝	mumbc	ф╕нцЧещЯУхЕ╝хо╣шбицДПцЦЗхнЧшгЬхЕЕ
Ёпз╛	mumbc	ф╕нцЧещЯУхЕ╝хо╣шбицДПцЦЗхнЧшгЬхЕЕ
Ёпз┐	mumbc	ф╕нцЧещЯУхЕ╝хо╣шбицДПцЦЗхнЧшгЬхЕЕ
т╝Х	mv	х║╖чЖЩщГищжЦ
т╝Ц	mv	х║╖чЖЩщГищжЦ
т╜Ы	mvdh	х║╖чЖЩщГищжЦ
т║Ы	mvku	ф╕нцЧещЯУщГищжЦшгЬхЕЕ
т╜б	mvni	х║╖чЖЩщГищжЦ
ядГ	mwbuc	ф╕нцЧещЯУхЕ╝хо╣шбицДПцЦЗхнЧ
язЪ	mwd	ф╕нцЧещЯУхЕ╝хо╣шбицДПцЦЗхнЧ
ядЩ	mwher	ф╕нцЧещЯУхЕ╝хо╣шбицДПцЦЗхнЧ
ялД	mwhxe	ф╕нцЧещЯУхЕ╝хо╣шбицДПцЦЗхнЧ
т╛п	mwsl	х║╖чЖЩщГищжЦ
яж╖	mwtwt	ф╕нцЧещЯУхЕ╝хо╣шбицДПцЦЗхнЧ
Ёпз╖	mwyjj	ф╕нцЧещЯУхЕ╝хо╣шбицДПцЦЗхнЧшгЬхЕЕ
ЁЭН┤	my	чоЧч▒МцХ╕хнЧ
ялЩ	mybl	ф╕нцЧещЯУхЕ╝хо╣шбицДПцЦЗхнЧ
ЁЭН╡	myl	чоЧч▒МцХ╕хнЧ
ЁЭН╢	mylm	чоЧч▒МцХ╕хнЧ
т╝Е	n	х║╖чЖЩщГищжЦ
т╝╕	n	х║╖чЖЩщГищжЦ
уЗЪ	n	ф╕нцЧещЯУчнЖчХл
т╛К	nau	х║╖чЖЩщГищжЦ
т╛У	nbg	х║╖чЖЩщГищжЦ
яй╢	nbks	ф╕нцЧещЯУхЕ╝хо╣шбицДПцЦЗхнЧ
т╗З	nboo	ф╕нцЧещЯУщГищжЦшгЬхЕЕ
т╗Ж	nbq	ф╕нцЧещЯУщГищжЦшгЬхЕЕ
т╝й	nc	х║╖чЖЩщГищжЦ
т╝ж	nd	х║╖чЖЩщГищжЦ
яз▓	nffdq	ф╕нцЧещЯУхЕ╝хо╣шбицДПцЦЗхнЧ
Ёпа╢	nhe	ф╕нцЧещЯУхЕ╝хо╣шбицДПцЦЗхнЧшгЬхЕЕ
т╝г	ni	х║╖чЖЩщГищжЦ
т╜н	ninh	х║╖чЖЩщГищжЦ
ЁпбЭ	nini	ф╕нцЧещЯУхЕ╝хо╣шбицДПцЦЗхнЧшгЬхЕЕ
т╛З	niq	х║╖чЖЩщГищжЦ
т╜и	niyo	х║╖чЖЩщГищжЦ
т╝Ь	nk	х║╖чЖЩщГищжЦ
т╗П	nl	ф╕нцЧещЯУщГищжЦшгЬхЕЕ
т╗Ц	nl	ф╕нцЧещЯУщГищжЦшгЬхЕЕ
яз▒	nlfdq	ф╕нцЧещЯУхЕ╝хо╣шбицДПцЦЗхнЧ
яеЩ	nlgce	ф╕нцЧещЯУхЕ╝хо╣шбицДПцЦЗхнЧ
язУ	nlgcg	ф╕нцЧещЯУхЕ╝хо╣шбицДПцЦЗхнЧ
язЬ	nlhem	ф╕нцЧещЯУхЕ╝хо╣шбицДПцЦЗхнЧ
яиЙ	nlheq	ф╕нцЧещЯУхЕ╝хо╣шбицДПцЦЗхнЧ
Ёпз▓	nlikf	ф╕нцЧещЯУхЕ╝хо╣шбицДПцЦЗхнЧшгЬхЕЕ
ялЖ	nljka	ф╕нцЧещЯУхЕ╝хо╣шбицДПцЦЗхнЧ
яеС	nlmbv	ф╕нцЧещЯУхЕ╝хо╣шбицДПцЦЗхнЧ
язЖ	nlmmu	ф╕нцЧещЯУхЕ╝хо╣шбицДПцЦЗхнЧ
т╝╣	nmm	х║╖чЖЩщГищжЦ
яж║	nn	ф╕нцЧещЯУхЕ╝хо╣шбицДПцЦЗхнЧ
уЗЖ	nn	ф╕нцЧещЯУчнЖчХл
уЗЛ	nn	ф╕нцЧещЯУчнЖчХл
уЗО	nn	ф╕нцЧещЯУчнЖчХл
т╝╡	nnk	х║╖чЖЩщГищжЦ
т╜Л	no	х║╖чЖЩщГищжЦ
т╗Ь	no	ф╕нцЧещЯУщГищжЦшгЬхЕЕ
Ёпа╕	noe	ф╕нцЧещЯУхЕ╝хо╣шбицДПцЦЗхнЧшгЬхЕЕ
ЁпбШ	nog	ф╕нцЧещЯУхЕ╝хо╣шбицДПцЦЗхнЧшгЬхЕЕ
т╛╢	nohto	х║╖чЖЩщГищжЦ
уЗМ	ns	ф╕нцЧещЯУчнЖчХл
уЗб	ns	ф╕нцЧещЯУчнЖчХл
ЁпзТ	nsho	ф╕нцЧещЯУхЕ╝хо╣шбицДПцЦЗхнЧшгЬхЕЕ
т╝Д	nu	х║╖чЖЩщГищжЦ
уЗа	nu	ф╕нцЧещЯУчнЖчХл
ЁпвФ	nue	ф╕нцЧещЯУхЕ╝хо╣шбицДПцЦЗхнЧшгЬхЕЕ
яи│	nuks	ф╕нцЧещЯУхЕ╝хо╣шбицДПцЦЗхнЧ
Ёпаж	nuks	ф╕нцЧещЯУхЕ╝хо╣шбицДПцЦЗхнЧшгЬхЕЕ
ЁпвХ	numk	ф╕нцЧещЯУхЕ╝хо╣шбицДПцЦЗхнЧшгЬхЕЕ
т║Д	nv	ф╕нцЧещЯУщГищжЦшгЬхЕЕ
т╗а	nv	ф╕нцЧещЯУщГищжЦшгЬхЕЕ
уЗЕ	nv	ф╕нцЧещЯУчнЖчХл
уЗИ	nv	ф╕нцЧещЯУчнЖчХл
уЗК	nv	ф╕нцЧещЯУчнЖчХл
уЗН	nv	ф╕нцЧещЯУчнЖчХл
т╗в	nvsm	ф╕нцЧещЯУщГищжЦшгЬхЕЕ
т┐╗	nvwm	шбицДПцЦЗхнЧцППш┐░хнЧчмж
т┐В	nwf	х║╖чЖЩщГищжЦ
яд╣	nwfa	ф╕нцЧещЯУхЕ╝хо╣шбицДПцЦЗхнЧ
Ёпае	nwks	ф╕нцЧещЯУхЕ╝хо╣шбицДПцЦЗхнЧшгЬхЕЕ
т╗▓	nwlu	ф╕нцЧещЯУщГищжЦшгЬхЕЕ
т╗е	nwm	ф╕нцЧещЯУщГищжЦшгЬхЕЕ
т╗│	nwu	ф╕нцЧещЯУщГищжЦшгЬхЕЕ
ядЗ	nxu	ф╕нцЧещЯУхЕ╝хо╣шбицДПцЦЗхнЧ
ядИ	nxu	ф╕нцЧещЯУхЕ╝хо╣шбицДПцЦЗхнЧ
т┐Ф	nxu	х║╖чЖЩщГищжЦ
т║к	nylm	ф╕нцЧещЯУщГищжЦшгЬхЕЕ
т╜ж	nyo	х║╖чЖЩщГищжЦ
т╝И	o	х║╖чЖЩщГищжЦ
уЗП	o	ф╕нцЧещЯУчнЖчХл
ЁпаФ	ob	ф╕нцЧещЯУхЕ╝хо╣шбицДПцЦЗхнЧшгЬхЕЕ
т╛Б	obo	х║╖чЖЩщГищжЦ
ЁпаЖ	ocru	ф╕нцЧещЯУхЕ╝хо╣шбицДПцЦЗхнЧшгЬхЕЕ
яи▒	ocwa	ф╕нцЧещЯУхЕ╝хо╣шбицДПцЦЗхнЧ
ЁпаК	ocwa	ф╕нцЧещЯУхЕ╝хо╣шбицДПцЦЗхнЧшгЬхЕЕ
т╛л	og	х║╖чЖЩщГищжЦ
т╝К	oh	х║╖чЖЩщГищжЦ
яй│	ohjn	ф╕нцЧещЯУхЕ╝хо╣шбицДПцЦЗхнЧ
ЁпаИ	ohya	ф╕нцЧещЯУхЕ╝хо╣шбицДПцЦЗхнЧшгЬхЕЕ
т╗Я	oiai	ф╕нцЧещЯУщГищжЦшгЬхЕЕ
т╗Ю	oias	ф╕нцЧещЯУщГищжЦшгЬхЕЕ
т╛╖	oiav	х║╖чЖЩщГищжЦ
т╗Э	oiav	ф╕нцЧещЯУщГищжЦшгЬхЕЕ
ЁпиГ	oifq	ф╕нцЧещЯУхЕ╝хо╣шбицДПцЦЗхнЧшгЬхЕЕ
уЛ┐	oihdr	ф╕нцЧещЯУхЬНч╣ЮхнЧчмжхПКцЬИф╗╜
ЁпиВ	oilu	ф╕нцЧещЯУхЕ╝хо╣шбицДПцЦЗхнЧшгЬхЕЕ
яжг	oinp	ф╕нцЧещЯУхЕ╝хо╣шбицДПцЦЗхнЧ
т║о	oioi	ф╕нцЧещЯУщГищжЦшгЬхЕЕ
ЁпиД	oioyo	ф╕нцЧещЯУхЕ╝хо╣шбицДПцЦЗхнЧшгЬхЕЕ
яз╜	oj	ф╕нцЧещЯУхЕ╝хо╣шбицДПцЦЗхнЧ
ЁпгИ	ojok	ф╕нцЧещЯУхЕ╝хо╣шбицДПцЦЗхнЧшгЬхЕЕ
т╜╕	oju	х║╖чЖЩщГищжЦ
т╜о	ok	х║╖чЖЩщГищжЦ
т║Щ	ok	ф╕нцЧещЯУщГищжЦшгЬхЕЕ
яж╗	okcf	ф╕нцЧещЯУхЕ╝хо╣шбицДПцЦЗхнЧ
Ёпдм	okmg	ф╕нцЧещЯУхЕ╝хо╣шбицДПцЦЗхнЧшгЬхЕЕ
Ёпдн	okmgi	ф╕нцЧещЯУхЕ╝хо╣шбицДПцЦЗхнЧшгЬхЕЕ
яйЩ	okvif	ф╕нцЧещЯУхЕ╝хо╣шбицДПцЦЗхнЧ
уЛ┐	olhdr	ф╕нцЧещЯУхЬНч╣ЮхнЧчмжхПКцЬИф╗╜
якп	olhf	ф╕нцЧещЯУхЕ╝хо╣шбицДПцЦЗхнЧ
яж┤	olmbc	ф╕нцЧещЯУхЕ╝хо╣шбицДПцЦЗхнЧ
якИ	ombp	ф╕нцЧещЯУхЕ╝хо╣шбицДПцЦЗхнЧ
яй▓	omg	ф╕нцЧещЯУхЕ╝хо╣шбицДПцЦЗхнЧ
яее	omlk	ф╕нцЧещЯУхЕ╝хо╣шбицДПцЦЗхнЧ
т╜У	omn	х║╖чЖЩщГищжЦ
яж╡	omnn	ф╕нцЧещЯУхЕ╝хо╣шбицДПцЦЗхнЧ
т╗Р	omp	ф╕нцЧещЯУщГищжЦшгЬхЕЕ
т┐Х	omrb	х║╖чЖЩщГищжЦ
яжи	omsl	ф╕нцЧещЯУхЕ╝хо╣шбицДПцЦЗхнЧ
ЁпаЛ	onbo	ф╕нцЧещЯУхЕ╝хо╣шбицДПцЦЗхнЧшгЬхЕЕ
Ёпад	onks	ф╕нцЧещЯУхЕ╝хо╣шбицДПцЦЗхнЧшгЬхЕЕ
ЁпаЩ	oo	ф╕нцЧещЯУхЕ╝хо╣шбицДПцЦЗхнЧшгЬхЕЕ
ЁпаД	oof	ф╕нцЧещЯУхЕ╝хо╣шбицДПцЦЗхнЧшгЬхЕЕ
язФ	oomb	ф╕нцЧещЯУхЕ╝хо╣шбицДПцЦЗхнЧ
ЁпаЕ	oowj	ф╕нцЧещЯУхЕ╝хо╣шбицДПцЦЗхнЧшгЬхЕЕ
яи░	oowy	ф╕нцЧещЯУхЕ╝хо╣шбицДПцЦЗхнЧ
яжО	oq	ф╕нцЧещЯУхЕ╝хо╣шбицДПцЦЗхнЧ
ЁпиЩ	orbus	ф╕нцЧещЯУхЕ╝хо╣шбицДПцЦЗхнЧшгЬхЕЕ
яйн	orjrr	ф╕нцЧещЯУхЕ╝хо╣шбицДПцЦЗхнЧ
ЁпиЩ	orrxu	ф╕нцЧещЯУхЕ╝хо╣шбицДПцЦЗхнЧшгЬхЕЕ
яим	osjrr	ф╕нцЧещЯУхЕ╝хо╣шбицДПцЦЗхнЧ
яик	osme	ф╕нцЧещЯУхЕ╝хо╣шбицДПцЦЗхнЧ
яил	ossmr	ф╕нцЧещЯУхЕ╝хо╣шбицДПцЦЗхнЧ
ЁпаЙ	otmb	ф╕нцЧещЯУхЕ╝хо╣шбицДПцЦЗхнЧшгЬхЕЕ
ЁпаМ	ougs	ф╕нцЧещЯУхЕ╝хо╣шбицДПцЦЗхнЧшгЬхЕЕ
Ёпе▓	oumjj	ф╕нцЧещЯУхЕ╝хо╣шбицДПцЦЗхнЧшгЬхЕЕ
Ёпе│	ousyj	ф╕нцЧещЯУхЕ╝хо╣шбицДПцЦЗхнЧшгЬхЕЕ
як▒	ouyjj	ф╕нцЧещЯУхЕ╝хо╣шбицДПцЦЗхнЧ
уЗГ	ov	ф╕нцЧещЯУчнЖчХл
ЁпиР	ovhaf	ф╕нцЧещЯУхЕ╝хо╣шбицДПцЦЗхнЧшгЬхЕЕ
ЁпаЗ	oyjj	ф╕нцЧещЯУхЕ╝хо╣шбицДПцЦЗхнЧшгЬхЕЕ
Ёпг╣	oykib	ф╕нцЧещЯУхЕ╝хо╣шбицДПцЦЗхнЧшгЬхЕЕ
яйБ	oyok	ф╕нцЧещЯУхЕ╝хо╣шбицДПцЦЗхнЧ
т╝╝	p	х║╖чЖЩщГищжЦ
ЁпвЧ	pavnb	ф╕нцЧещЯУхЕ╝хо╣шбицДПцЦЗхнЧшгЬхЕЕ
якЖ	pbtv	ф╕нцЧещЯУхЕ╝хо╣шбицДПцЦЗхнЧ
ЁпеЕ	pbvc	ф╕нцЧещЯУхЕ╝хо╣шбицДПцЦЗхнЧшгЬхЕЕ
ЁпаУ	pcpbc	ф╕нцЧещЯУхЕ╝хо╣шбицДПцЦЗхнЧшгЬхЕЕ
яи┐	pcwa	ф╕нцЧещЯУхЕ╝хо╣шбицДПцЦЗхнЧ
якЙ	pcwa	ф╕нцЧещЯУхЕ╝хо╣шбицДПцЦЗхнЧ
Ёпвл	pcwa	ф╕нцЧещЯУхЕ╝хо╣шбицДПцЦЗхнЧшгЬхЕЕ
Ёпв▒	pdlc	ф╕нцЧещЯУхЕ╝хо╣шбицДПцЦЗхнЧшгЬхЕЕ
Ёпвд	pdwf	ф╕нцЧещЯУхЕ╝хо╣шбицДПцЦЗхнЧшгЬхЕЕ
яжП	pfdq	ф╕нцЧещЯУхЕ╝хо╣шбицДПцЦЗхнЧ
якК	pgsk	ф╕нцЧещЯУхЕ╝хо╣шбицДПцЦЗхнЧ
ялР	phka	ф╕нцЧещЯУхЕ╝хо╣шбицДПцЦЗхнЧ
ялП	phkp	ф╕нцЧещЯУхЕ╝хо╣шбицДПцЦЗхнЧ
яи╛	phsu	ф╕нцЧещЯУхЕ╝хо╣шбицДПцЦЗхнЧ
яй╖	pi	ф╕нцЧещЯУхЕ╝хо╣шбицДПцЦЗхнЧ
Ёпва	pib	ф╕нцЧещЯУхЕ╝хо╣шбицДПцЦЗхнЧшгЬхЕЕ
Ёпвв	pihm	ф╕нцЧещЯУхЕ╝хо╣шбицДПцЦЗхнЧшгЬхЕЕ
якЗ	pjbc	ф╕нцЧещЯУхЕ╝хо╣шбицДПцЦЗхнЧ
ЁпиЖ	pjsqf	ф╕нцЧещЯУхЕ╝хо╣шбицДПцЦЗхнЧшгЬхЕЕ
Ёпвн	pjtc	ф╕нцЧещЯУхЕ╝хо╣шбицДПцЦЗхнЧшгЬхЕЕ
Ёпви	pjuc	ф╕нцЧещЯУхЕ╝хо╣шбицДПцЦЗхнЧшгЬхЕЕ
ЁпзЭ	pjwj	ф╕нцЧещЯУхЕ╝хо╣шбицДПцЦЗхнЧшгЬхЕЕ
Ёпак	pkk	ф╕нцЧещЯУхЕ╝хо╣шбицДПцЦЗхнЧшгЬхЕЕ
Ёпвп	plbo	ф╕нцЧещЯУхЕ╝хо╣шбицДПцЦЗхнЧшгЬхЕЕ
Ёпвк	pllv	ф╕нцЧещЯУхЕ╝хо╣шбицДПцЦЗхнЧшгЬхЕЕ
Ёпаи	pm	ф╕нцЧещЯУхЕ╝хо╣шбицДПцЦЗхнЧшгЬхЕЕ
ЁпвЯ	pmg	ф╕нцЧещЯУхЕ╝хо╣шбицДПцЦЗхнЧшгЬхЕЕ
язЩ	pmwd	ф╕нцЧещЯУхЕ╝хо╣шбицДПцЦЗхнЧ
т╗У	po	ф╕нцЧещЯУщГищжЦшгЬхЕЕ
яжм	poml	ф╕нцЧещЯУхЕ╝хо╣шбицДПцЦЗхнЧ
Ёпвг	powj	ф╕нцЧещЯУхЕ╝хо╣шбицДПцЦЗхнЧшгЬхЕЕ
яи╜	powy	ф╕нцЧещЯУхЕ╝хо╣шбицДПцЦЗхнЧ
т╜Р	pp	х║╖чЖЩщГищжЦ
ядЖ	pr	ф╕нцЧещЯУхЕ╝хо╣шбицДПцЦЗхнЧ
яиА	psh	ф╕нцЧещЯУхЕ╝хо╣шбицДПцЦЗхнЧ
Ёпай	psu	ф╕нцЧещЯУхЕ╝хо╣шбицДПцЦЗхнЧшгЬхЕЕ
Ёпвз	ptvu	ф╕нцЧещЯУхЕ╝хо╣шбицДПцЦЗхнЧшгЬхЕЕ
Ёпвй	ptyu	ф╕нцЧещЯУхЕ╝хо╣шбицДПцЦЗхнЧшгЬхЕЕ
Ёпве	pysd	ф╕нцЧещЯУхЕ╝хо╣шбицДПцЦЗхнЧшгЬхЕЕ
т╗ж	pysm	ф╕нцЧещЯУщГищжЦшгЬхЕЕ
Ёпвб	pyvu	ф╕нцЧещЯУхЕ╝хо╣шбицДПцЦЗхнЧшгЬхЕЕ
т╝┐	q	х║╖чЖЩщГищжЦ
ЁпгЕ	qbhf	ф╕нцЧещЯУхЕ╝хо╣шбицДПцЦЗхнЧшгЬхЕЕ
яжС	qbkf	ф╕нцЧещЯУхЕ╝хо╣шбицДПцЦЗхнЧ
т╜╛	qd	х║╖чЖЩщГищжЦ
Ёпе╝	qdish	ф╕нцЧещЯУхЕ╝хо╣шбицДПцЦЗхнЧшгЬхЕЕ
Ёпв╕	qhie	ф╕нцЧещЯУхЕ╝хо╣шбицДПцЦЗхнЧшгЬхЕЕ
ядЙ	qhk	ф╕нцЧещЯУхЕ╝хо╣шбицДПцЦЗхнЧ
Ёпв╜	qhpl	ф╕нцЧещЯУхЕ╝хо╣шбицДПцЦЗхнЧшгЬхЕЕ
ЁпгВ	qhsn	ф╕нцЧещЯУхЕ╝хо╣шбицДПцЦЗхнЧшгЬхЕЕ
якО	qhxe	ф╕нцЧещЯУхЕ╝хо╣шбицДПцЦЗхнЧ
Ёпв╖	qib	ф╕нцЧещЯУхЕ╝хо╣шбицДПцЦЗхнЧшгЬхЕЕ
Ёпв╢	qike	ф╕нцЧещЯУхЕ╝хо╣шбицДПцЦЗхнЧшгЬхЕЕ
Ёпв╛	qjfe	ф╕нцЧещЯУхЕ╝хо╣шбицДПцЦЗхнЧшгЬхЕЕ
Ёпб▓	qkdi	ф╕нцЧещЯУхЕ╝хо╣шбицДПцЦЗхнЧшгЬхЕЕ
ЁпгБ	qkhu	ф╕нцЧещЯУхЕ╝хо╣шбицДПцЦЗхнЧшгЬхЕЕ
Ёпво	qkua	ф╕нцЧещЯУхЕ╝хо╣шбицДПцЦЗхнЧшгЬхЕЕ
т╛н	qmb	х║╖чЖЩщГищжЦ
т╗Ш	qmb	ф╕нцЧещЯУщГищжЦшгЬхЕЕ
т╛н	qmblm	х║╖чЖЩщГищжЦ
Ёпв┐	qmca	ф╕нцЧещЯУхЕ╝хо╣шбицДПцЦЗхнЧшгЬхЕЕ
т╗и	qme	ф╕нцЧещЯУщГищжЦшгЬхЕЕ
Ёпв┤	qmjs	ф╕нцЧещЯУхЕ╝хо╣шбицДПцЦЗхнЧшгЬхЕЕ
яиВ	qmr	ф╕нцЧещЯУхЕ╝хо╣шбицДПцЦЗхнЧ
ЁпгД	qnri	ф╕нцЧещЯУхЕ╝хо╣шбицДПцЦЗхнЧшгЬхЕЕ
Ёпв╗	qogr	ф╕нцЧещЯУхЕ╝хо╣шбицДПцЦЗхнЧшгЬхЕЕ
яжд	qoip	ф╕нцЧещЯУхЕ╝хо╣шбицДПцЦЗхнЧ
яжШ	qojwj	ф╕нцЧещЯУхЕ╝хо╣шбицДПцЦЗхнЧ
якН	qomn	ф╕нцЧещЯУхЕ╝хо╣шбицДПцЦЗхнЧ
яе│	qomr	ф╕нцЧещЯУхЕ╝хо╣шбицДПцЦЗхнЧ
ЁпвЮ	qp	ф╕нцЧещЯУхЕ╝хо╣шбицДПцЦЗхнЧшгЬхЕЕ
Ёпв╡	qpsu	ф╕нцЧещЯУхЕ╝хо╣шбицДПцЦЗхнЧшгЬхЕЕ
т╗Щ	qs	ф╕нцЧещЯУщГищжЦшгЬхЕЕ
Ёпв╣	qshu	ф╕нцЧещЯУхЕ╝хо╣шбицДПцЦЗхнЧшгЬхЕЕ
Ёпв╝	qsmb	ф╕нцЧещЯУхЕ╝хо╣шбицДПцЦЗхнЧшгЬхЕЕ
якР	qsok	ф╕нцЧещЯУхЕ╝хо╣шбицДПцЦЗхнЧ
якП	qsyj	ф╕нцЧещЯУхЕ╝хо╣шбицДПцЦЗхнЧ
ЁпгЖ	qvvd	ф╕нцЧещЯУхЕ╝хо╣шбицДПцЦЗхнЧшгЬхЕЕ
ЁпгЗ	qyci	ф╕нцЧещЯУхЕ╝хо╣шбицДПцЦЗхнЧшгЬхЕЕ
Ёпв║	qyjj	ф╕нцЧещЯУхЕ╝хо╣шбицДПцЦЗхнЧшгЬхЕЕ
яд░	qyps	ф╕нцЧещЯУхЕ╝хо╣шбицДПцЦЗхнЧ
яе╡	qyrf	ф╕нцЧещЯУхЕ╝хо╣шбицДПцЦЗхнЧ
яде	qyt	ф╕нцЧещЯУхЕ╝хо╣шбицДПцЦЗхнЧ
т╝Э	r	х║╖чЖЩщГищжЦ
яй╗	rabt	ф╕нцЧещЯУхЕ╝хо╣шбицДПцЦЗхнЧ
яй╕	rapp	ф╕нцЧещЯУхЕ╝хо╣шбицДПцЦЗхнЧ
яи╢	rapv	ф╕нцЧещЯУхЕ╝хо╣шбицДПцЦЗхнЧ
т╛в	rau	х║╖чЖЩщГищжЦ
ЁпбК	rbou	ф╕нцЧещЯУхЕ╝хо╣шбицДПцЦЗхнЧшгЬхЕЕ
ЁпбЙ	rdbm	ф╕нцЧещЯУхЕ╝хо╣шбицДПцЦЗхнЧшгЬхЕЕ
ядЛ	rdln	ф╕нцЧещЯУхЕ╝хо╣шбицДПцЦЗхнЧ
ЁпбО	rhaj	ф╕нцЧещЯУхЕ╝хо╣шбицДПцЦЗхнЧшгЬхЕЕ
Ёпа╗	rhi	ф╕нцЧещЯУхЕ╝хо╣шбицДПцЦЗхнЧшгЬхЕЕ
яжА	rhr	ф╕нцЧещЯУхЕ╝хо╣шбицДПцЦЗхнЧ
ЁпбП	rjtc	ф╕нцЧещЯУхЕ╝хо╣шбицДПцЦЗхнЧшгЬхЕЕ
т╗к	rlwu	ф╕нцЧещЯУщГищжЦшгЬхЕЕ
Ёпа╛	rmg	ф╕нцЧещЯУхЕ╝хо╣шбицДПцЦЗхнЧшгЬхЕЕ
яд╖	rmher	ф╕нцЧещЯУхЕ╝хо╣шбицДПцЦЗхнЧ
ЁпзЪ	rmike	ф╕нцЧещЯУхЕ╝хо╣шбицДПцЦЗхнЧшгЬхЕЕ
ЁпзЫ	rmmjj	ф╕нцЧещЯУхЕ╝хо╣шбицДПцЦЗхнЧшгЬхЕЕ
Ёпа╝	rmt	ф╕нцЧещЯУхЕ╝хо╣шбицДПцЦЗхнЧшгЬхЕЕ
ЁпзЬ	rmyjj	ф╕нцЧещЯУхЕ╝хо╣шбицДПцЦЗхнЧшгЬхЕЕ
Ёпа╜	rnhe	ф╕нцЧещЯУхЕ╝хо╣шбицДПцЦЗхнЧшгЬхЕЕ
яй║	rnmo	ф╕нцЧещЯУхЕ╝хо╣шбицДПцЦЗхнЧ
ЁпбЗ	rnmo	ф╕нцЧещЯУхЕ╝хо╣шбицДПцЦЗхнЧшгЬхЕЕ
ЁпбД	roul	ф╕нцЧещЯУхЕ╝хо╣шбицДПцЦЗхнЧшгЬхЕЕ
Ёпа║	rp	ф╕нцЧещЯУхЕ╝хо╣шбицДПцЦЗхнЧшгЬхЕЕ
яй╣	rpov	ф╕нцЧещЯУхЕ╝хо╣шбицДПцЦЗхнЧ
ЁпбИ	rqhk	ф╕нцЧещЯУхЕ╝хо╣шбицДПцЦЗхнЧшгЬхЕЕ
яд║	rrhaf	ф╕нцЧещЯУхЕ╝хо╣шбицДПцЦЗхнЧ
яи╕	rrikr	ф╕нцЧещЯУхЕ╝хо╣шбицДПцЦЗхнЧ
ЁпбА	rrmjs	ф╕нцЧещЯУхЕ╝хо╣шбицДПцЦЗхнЧшгЬхЕЕ
ЁпбМ	rtao	ф╕нцЧещЯУхЕ╝хо╣шбицДПцЦЗхнЧшгЬхЕЕ
яи╖	rtlo	ф╕нцЧещЯУхЕ╝хо╣шбицДПцЦЗхнЧ
ЁпбБ	rtq	ф╕нцЧещЯУхЕ╝хо╣шбицДПцЦЗхнЧшгЬхЕЕ
т║Т	ru	ф╕нцЧещЯУщГищжЦшгЬхЕЕ
ЁпвД	rutc	ф╕нцЧещЯУхЕ╝хо╣шбицДПцЦЗхнЧшгЬхЕЕ
Ёпа╣	rvl	ф╕нцЧещЯУхЕ╝хо╣шбицДПцЦЗхнЧшгЬхЕЕ
т║а	rvp	ф╕нцЧещЯУщГищжЦшгЬхЕЕ
яжЮ	rwk	ф╕нцЧещЯУхЕ╝хо╣шбицДПцЦЗхнЧ
ЁпиШ	rwu	ф╕нцЧещЯУхЕ╝хо╣шбицДПцЦЗхнЧшгЬхЕЕ
т┐М	rxu	х║╖чЖЩщГищжЦ
т╗К	rylm	ф╕нцЧещЯУщГищжЦшгЬхЕЕ
т╛Ь	ryo	х║╖чЖЩщГищжЦ
т╝л	s	х║╖чЖЩщГищжЦ
яи╗	scwa	ф╕нцЧещЯУхЕ╝хо╣шбицДПцЦЗхнЧ
яж╜	se	ф╕нцЧещЯУхЕ╝хо╣шбицДПцЦЗхнЧ
ЁпиЦ	sehde	ф╕нцЧещЯУхЕ╝хо╣шбицДПцЦЗхнЧшгЬхЕЕ
Ёпдд	sehq	ф╕нцЧещЯУхЕ╝хо╣шбицДПцЦЗхнЧшгЬхЕЕ
ЁпиЗ	sfcru	ф╕нцЧещЯУхЕ╝хо╣шбицДПцЦЗхнЧшгЬхЕЕ
ядЪ	sfher	ф╕нцЧещЯУхЕ╝хо╣шбицДПцЦЗхнЧ
яжЗ	sfmmp	ф╕нцЧещЯУхЕ╝хо╣шбицДПцЦЗхнЧ
т╝С	sh	х║╖чЖЩщГищжЦ
ЁпаП	shahi	ф╕нцЧещЯУхЕ╝хо╣шбицДПцЦЗхнЧшгЬхЕЕ
яи▓	shahu	ф╕нцЧещЯУхЕ╝хо╣шбицДПцЦЗхнЧ
ЁпаО	shahu	ф╕нцЧещЯУхЕ╝хо╣шбицДПцЦЗхнЧшгЬхЕЕ
язТ	shi	ф╕нцЧещЯУхЕ╝хо╣шбицДПцЦЗхнЧ
ялН	shjbc	ф╕нцЧещЯУхЕ╝хо╣шбицДПцЦЗхнЧ
ЁпиК	shjbc	ф╕нцЧещЯУхЕ╝хо╣шбицДПцЦЗхнЧшгЬхЕЕ
Ёпб▒	shjtu	ф╕нцЧещЯУхЕ╝хо╣шбицДПцЦЗхнЧшгЬхЕЕ
ЁпиЙ	shmhn	ф╕нцЧещЯУхЕ╝хо╣шбицДПцЦЗхнЧшгЬхЕЕ
язЯ	shoe	ф╕нцЧещЯУхЕ╝хо╣шбицДПцЦЗхнЧ
т╛╜	sihhh	х║╖чЖЩщГищжЦ
т╜┐	sj	х║╖чЖЩщГищжЦ
Ёпе┐	sjhwp	ф╕нцЧещЯУхЕ╝хо╣шбицДПцЦЗхнЧшгЬхЕЕ
Ёпб╖	sjka	ф╕нцЧещЯУхЕ╝хо╣шбицДПцЦЗхнЧшгЬхЕЕ
яж░	sjoml	ф╕нцЧещЯУхЕ╝хо╣шбицДПцЦЗхнЧ
яжЧ	sjvit	ф╕нцЧещЯУхЕ╝хо╣шбицДПцЦЗхнЧ
Ёпе╜	sjyjj	ф╕нцЧещЯУхЕ╝хо╣шбицДПцЦЗхнЧшгЬхЕЕ
ЁпаЮ	sk	ф╕нцЧещЯУхЕ╝хо╣шбицДПцЦЗхнЧшгЬхЕЕ
ЁпвЭ	skp	ф╕нцЧещЯУхЕ╝хо╣шбицДПцЦЗхнЧшгЬхЕЕ
т╝Щ	sl	х║╖чЖЩщГищжЦ
яеЛ	sllv	ф╕нцЧещЯУхЕ╝хо╣шбицДПцЦЗхнЧ
яз╢	slorr	ф╕нцЧещЯУхЕ╝хо╣шбицДПцЦЗхнЧ
т╛В	slsl	х║╖чЖЩщГищжЦ
т║Х	sm	ф╕нцЧещЯУщГищжЦшгЬхЕЕ
ЁпвЦ	smhhb	ф╕нцЧещЯУхЕ╝хо╣шбицДПцЦЗхнЧшгЬхЕЕ
т╗Т	smi	ф╕нцЧещЯУщГищжЦшгЬхЕЕ
т╜╗	smsim	х║╖чЖЩщГищжЦ
яиЮ	smsmm	ф╕нцЧещЯУхЕ╝хо╣шбицДПцЦЗхнЧ
т╛з	smv	х║╖чЖЩщГищжЦ
т╗С	smv	ф╕нцЧещЯУщГищжЦшгЬхЕЕ
Ёпг╖	snhne	ф╕нцЧещЯУхЕ╝хо╣шбицДПцЦЗхнЧшгЬхЕЕ
т╛║	sqsf	х║╖чЖЩщГищжЦ
язл	stkr	ф╕нцЧещЯУхЕ╝хо╣шбицДПцЦЗхнЧ
т╝░	su	х║╖чЖЩщГищжЦ
т║Л	su	ф╕нцЧещЯУщГищжЦшгЬхЕЕ
яйм	suf	ф╕нцЧещЯУхЕ╝хо╣шбицДПцЦЗхнЧ
Ёпзв	sunl	ф╕нцЧещЯУхЕ╝хо╣шбицДПцЦЗхнЧшгЬхЕЕ
ЁпжЫ	tail	ф╕нцЧещЯУхЕ╝хо╣шбицДПцЦЗхнЧшгЬхЕЕ
Ёпжж	tajt	ф╕нцЧещЯУхЕ╝хо╣шбицДПцЦЗхнЧшгЬхЕЕ
яз░	tang	ф╕нцЧещЯУхЕ╝хо╣шбицДПцЦЗхнЧ
Ёпжп	tanr	ф╕нцЧещЯУхЕ╝хо╣шбицДПцЦЗхнЧшгЬхЕЕ
ядЯ	tanw	ф╕нцЧещЯУхЕ╝хо╣шбицДПцЦЗхнЧ
ЁпжЪ	tbd	ф╕нцЧещЯУхЕ╝хо╣шбицДПцЦЗхнЧшгЬхЕЕ
Ёпжг	tbd	ф╕нцЧещЯУхЕ╝хо╣шбицДПцЦЗхнЧшгЬхЕЕ
ЁпжТ	tbks	ф╕нцЧещЯУхЕ╝хо╣шбицДПцЦЗхнЧшгЬхЕЕ
якж	tcbt	ф╕нцЧещЯУхЕ╝хо╣шбицДПцЦЗхнЧ
т┐Л	tcfb	х║╖чЖЩщГищжЦ
ЁпгЮ	td	ф╕нцЧещЯУхЕ╝хо╣шбицДПцЦЗхнЧшгЬхЕЕ
ядШ	tehr	ф╕нцЧещЯУхЕ╝хо╣шбицДПцЦЗхнЧ
Ёпжн	temt	ф╕нцЧещЯУхЕ╝хо╣шбицДПцЦЗхнЧшгЬхЕЕ
Ёпжи	teyj	ф╕нцЧещЯУхЕ╝хо╣шбицДПцЦЗхнЧшгЬхЕЕ
т║╖	tg	ф╕нцЧещЯУщГищжЦшгЬхЕЕ
яеШ	tgce	ф╕нцЧещЯУхЕ╝хо╣шбицДПцЦЗхнЧ
Ёпжд	tgpr	ф╕нцЧещЯУхЕ╝хо╣шбицДПцЦЗхнЧшгЬхЕЕ
ЁпбЖ	tgtr	ф╕нцЧещЯУхЕ╝хо╣шбицДПцЦЗхнЧшгЬхЕЕ
Ёпе╕	tgye	ф╕нцЧещЯУхЕ╝хо╣шбицДПцЦЗхнЧшгЬхЕЕ
т╛╕	thbu	х║╖чЖЩщГищжЦ
Ёпжо	thdb	ф╕нцЧещЯУхЕ╝хо╣шбицДПцЦЗхнЧшгЬхЕЕ
яиа	thdu	ф╕нцЧещЯУхЕ╝хо╣шбицДПцЦЗхнЧ
ЁпжЮ	tihp	ф╕нцЧещЯУхЕ╝хо╣шбицДПцЦЗхнЧшгЬхЕЕ
ЁпжС	tino	ф╕нцЧещЯУхЕ╝хо╣шбицДПцЦЗхнЧшгЬхЕЕ
яйЯ	tjka	ф╕нцЧещЯУхЕ╝хо╣шбицДПцЦЗхнЧ
ЁпжЯ	tjka	ф╕нцЧещЯУхЕ╝хо╣шбицДПцЦЗхнЧшгЬхЕЕ
яеТ	tjks	ф╕нцЧещЯУхЕ╝хо╣шбицДПцЦЗхнЧ
ЁпжЦ	tjr	ф╕нцЧещЯУхЕ╝хо╣шбицДПцЦЗхнЧшгЬхЕЕ
Ёпз╕	tjsme	ф╕нцЧещЯУхЕ╝хо╣шбицДПцЦЗхнЧшгЬхЕЕ
Ёпз╣	tjumi	ф╕нцЧещЯУхЕ╝хо╣шбицДПцЦЗхнЧшгЬхЕЕ
яе┤	tkr	ф╕нцЧещЯУхЕ╝хо╣шбицДПцЦЗхнЧ
ЁпжШ	tkr	ф╕нцЧещЯУхЕ╝хо╣шбицДПцЦЗхнЧшгЬхЕЕ
ЁпжЭ	tkt	ф╕нцЧещЯУхЕ╝хо╣шбицДПцЦЗхнЧшгЬхЕЕ
Ёпжл	tlii	ф╕нцЧещЯУхЕ╝хо╣шбицДПцЦЗхнЧшгЬхЕЕ
т╛░	tlj	х║╖чЖЩщГищжЦ
т╗й	tlwc	ф╕нцЧещЯУщГищжЦшгЬхЕЕ
т╜в	tm	х║╖чЖЩщГищжЦ
Ёпже	tmbf	ф╕нцЧещЯУхЕ╝хо╣шбицДПцЦЗхнЧшгЬхЕЕ
ЁпжР	tmd	ф╕нцЧещЯУхЕ╝хо╣шбицДПцЦЗхнЧшгЬхЕЕ
ЁпиЧ	tmfb	ф╕нцЧещЯУхЕ╝хо╣шбицДПцЦЗхнЧшгЬхЕЕ
т║╕	tmj	ф╕нцЧещЯУщГищжЦшгЬхЕЕ
яи┤	tmks	ф╕нцЧещЯУхЕ╝хо╣шбицДПцЦЗхнЧ
Ёпаз	tmks	ф╕нцЧещЯУхЕ╝хо╣шбицДПцЦЗхнЧшгЬхЕЕ
т┐И	tmlc	х║╖чЖЩщГищжЦ
як┤	tmtj	ф╕нцЧещЯУхЕ╝хо╣шбицДПцЦЗхнЧ
ЁпжХ	tmvh	ф╕нцЧещЯУхЕ╝хо╣шбицДПцЦЗхнЧшгЬхЕЕ
ЁпжЧ	tnf	ф╕нцЧещЯУхЕ╝хо╣шбицДПцЦЗхнЧшгЬхЕЕ
Ёпжз	tnmb	ф╕нцЧещЯУхЕ╝хо╣шбицДПцЦЗхнЧшгЬхЕЕ
яз╛	tod	ф╕нцЧещЯУхЕ╝хо╣шбицДПцЦЗхнЧ
Ёпжм	tohqm	ф╕нцЧещЯУхЕ╝хо╣шбицДПцЦЗхнЧшгЬхЕЕ
яйи	toog	ф╕нцЧещЯУхЕ╝хо╣шбицДПцЦЗхнЧ
ялЗ	toog	ф╕нцЧещЯУхЕ╝хо╣шбицДПцЦЗхнЧ
ЁпжУ	top	ф╕нцЧещЯУхЕ╝хо╣шбицДПцЦЗхнЧшгЬхЕЕ
Ёпжб	tpfd	ф╕нцЧещЯУхЕ╝хо╣шбицДПцЦЗхнЧшгЬхЕЕ
яео	tptd	ф╕нцЧещЯУхЕ╝хо╣шбицДПцЦЗхнЧ
т╜║	tq	х║╖чЖЩщГищжЦ
т║╢	tq	ф╕нцЧещЯУщГищжЦшгЬхЕЕ
якк	tqbu	ф╕нцЧещЯУхЕ╝хо╣шбицДПцЦЗхнЧ
яжп	tqoml	ф╕нцЧещЯУхЕ╝хо╣шбицДПцЦЗхнЧ
Ёпж░	tqvd	ф╕нцЧещЯУхЕ╝хо╣шбицДПцЦЗхнЧшгЬхЕЕ
ЁпжЬ	trmk	ф╕нцЧещЯУхЕ╝хо╣шбицДПцЦЗхнЧшгЬхЕЕ
ЁпгЙ	trok	ф╕нцЧещЯУхЕ╝хо╣шбицДПцЦЗхнЧшгЬхЕЕ
ЁпдЫ	tsf	ф╕нцЧещЯУхЕ╝хо╣шбицДПцЦЗхнЧшгЬхЕЕ
ЁпжЩ	tsll	ф╕нцЧещЯУхЕ╝хо╣шбицДПцЦЗхнЧшгЬхЕЕ
язВ	tsmh	ф╕нцЧещЯУхЕ╝хо╣шбицДПцЦЗхнЧ
ядг	tsmt	ф╕нцЧещЯУхЕ╝хо╣шбицДПцЦЗхнЧ
ЁпжП	tsu	ф╕нцЧещЯУхЕ╝хо╣шбицДПцЦЗхнЧшгЬхЕЕ
Ёпжй	ttlm	ф╕нцЧещЯУхЕ╝хо╣шбицДПцЦЗхнЧшгЬхЕЕ
яй░	ttm	ф╕нцЧещЯУхЕ╝хо╣шбицДПцЦЗхнЧ
ЁпбЕ	ttr	ф╕нцЧещЯУхЕ╝хо╣шбицДПцЦЗхнЧшгЬхЕЕ
Ёпж▒	tvfv	ф╕нцЧещЯУхЕ╝хо╣шбицДПцЦЗхнЧшгЬхЕЕ
Ёпвж	tvip	ф╕нцЧещЯУхЕ╝хо╣шбицДПцЦЗхнЧшгЬхЕЕ
яд╛	tvne	ф╕нцЧещЯУхЕ╝хо╣шбицДПцЦЗхнЧ
як│	tvou	ф╕нцЧещЯУхЕ╝хо╣шбицДПцЦЗхнЧ
Ёпжв	twhd	ф╕нцЧещЯУхЕ╝хо╣шбицДПцЦЗхнЧшгЬхЕЕ
ядР	twlg	ф╕нцЧещЯУхЕ╝хо╣шбицДПцЦЗхнЧ
ЁпбЮ	twln	ф╕нцЧещЯУхЕ╝хо╣шбицДПцЦЗхнЧшгЬхЕЕ
Ёпж▓	tyce	ф╕нцЧещЯУхЕ╝хо╣шбицДПцЦЗхнЧшгЬхЕЕ
яжЩ	tyjj	ф╕нцЧещЯУхЕ╝хо╣шбицДПцЦЗхнЧ
Ёпжа	tyjj	ф╕нцЧещЯУхЕ╝хо╣шбицДПцЦЗхнЧшгЬхЕЕ
Ёпжк	typm	ф╕нцЧещЯУхЕ╝хо╣шбицДПцЦЗхнЧшгЬхЕЕ
яд╡	typt	ф╕нцЧещЯУхЕ╝хо╣шбицДПцЦЗхнЧ
т╝н	u	х║╖чЖЩщГищжЦ
Ёпб╕	uh	ф╕нцЧещЯУхЕ╝хо╣шбицДПцЦЗхнЧшгЬхЕЕ
т╝Ф	uh	х║╖чЖЩщГищжЦ
т╝м	uh	х║╖чЖЩщГищжЦ
ядб	uhni	ф╕нцЧещЯУхЕ╝хо╣шбицДПцЦЗхнЧ
т╛┐	uip	х║╖чЖЩщГищжЦ
ЁпдЪ	ukf	ф╕нцЧещЯУхЕ╝хо╣шбицДПцЦЗхнЧшгЬхЕЕ
яи╝	ul	ф╕нцЧещЯУхЕ╝хо╣шбицДПцЦЗхнЧ
Ёпб╕	ul	ф╕нцЧещЯУхЕ╝хо╣шбицДПцЦЗхнЧшгЬхЕЕ
т╝м	ul	х║╖чЖЩщГищжЦ
Ёпб╣	ulw	ф╕нцЧещЯУхЕ╝хо╣шбицДПцЦЗхнЧшгЬхЕЕ
Ёпб║	umjj	ф╕нцЧещЯУхЕ╝хо╣шбицДПцЦЗхнЧшгЬхЕЕ
Ёпж╖	umli	ф╕нцЧещЯУхЕ╝хо╣шбицДПцЦЗхнЧшгЬхЕЕ
Ёпж╖	umlmi	ф╕нцЧещЯУхЕ╝хо╣шбицДПцЦЗхнЧшгЬхЕЕ
ядА	umrt	ф╕нцЧещЯУхЕ╝хо╣шбицДПцЦЗхнЧ
Ёпз┤	uogs	ф╕нцЧещЯУхЕ╝хо╣шбицДПцЦЗхнЧшгЬхЕЕ
яжл	uolc	ф╕нцЧещЯУхЕ╝хо╣шбицДПцЦЗхнЧ
язХ	uomb	ф╕нцЧещЯУхЕ╝хо╣шбицДПцЦЗхнЧ
Ёпб╛	upbc	ф╕нцЧещЯУхЕ╝хо╣шбицДПцЦЗхнЧшгЬхЕЕ
Ёпб╗	urvk	ф╕нцЧещЯУхЕ╝хо╣шбицДПцЦЗхнЧшгЬхЕЕ
Ёпб┐	utvi	ф╕нцЧещЯУхЕ╝хо╣шбицДПцЦЗхнЧшгЬхЕЕ
т╛Л	uu	х║╖чЖЩщГищжЦ
ЁпжФ	uuyhs	ф╕нцЧещЯУхЕ╝хо╣шбицДПцЦЗхнЧшгЬхЕЕ
Ёпг╕	uwyi	ф╕нцЧещЯУхЕ╝хо╣шбицДПцЦЗхнЧшгЬхЕЕ
Ёпб╝	uyhh	ф╕нцЧещЯУхЕ╝хо╣шбицДПцЦЗхнЧшгЬхЕЕ
ЁпвА	uyhm	ф╕нцЧещЯУхЕ╝хо╣шбицДПцЦЗхнЧшгЬхЕЕ
яжБ	v	ф╕нцЧещЯУхЕ╝хо╣шбицДПцЦЗхнЧ
т╝е	v	х║╖чЖЩщГищжЦ
уЗЩ	v	ф╕нцЧещЯУчнЖчХл
Ёпбд	vcru	ф╕нцЧещЯУхЕ╝хо╣шбицДПцЦЗхнЧшгЬхЕЕ
Ёпбк	vdlc	ф╕нцЧещЯУхЕ╝хо╣шбицДПцЦЗхнЧшгЬхЕЕ
Ёпбл	vdlc	ф╕нцЧещЯУхЕ╝хо╣шбицДПцЦЗхнЧшгЬхЕЕ
Ёпзж	vdnl	ф╕нцЧещЯУхЕ╝хо╣шбицДПцЦЗхнЧшгЬхЕЕ
яеа	vep	ф╕нцЧещЯУхЕ╝хо╣шбицДПцЦЗхнЧ
яеЫ	veq	ф╕нцЧещЯУхЕ╝хо╣шбицДПцЦЗхнЧ
Ёпеп	vfcrp	ф╕нцЧещЯУхЕ╝хо╣шбицДПцЦЗхнЧшгЬхЕЕ
як░	vfdw	ф╕нцЧещЯУхЕ╝хо╣шбицДПцЦЗхнЧ
яжЦ	vfdwf	ф╕нцЧещЯУхЕ╝хо╣шбицДПцЦЗхнЧ
яйЧ	vfdwf	ф╕нцЧещЯУхЕ╝хо╣шбицДПцЦЗхнЧ
яеЧ	vfgce	ф╕нцЧещЯУхЕ╝хо╣шбицДПцЦЗхнЧ
яда	vfhaf	ф╕нцЧещЯУхЕ╝хо╣шбицДПцЦЗхнЧ
ЁпзС	vfhe	ф╕нцЧещЯУхЕ╝хо╣шбицДПцЦЗхнЧшгЬхЕЕ
яеР	vfllv	ф╕нцЧещЯУхЕ╝хо╣шбицДПцЦЗхнЧ
яйШ	vfmca	ф╕нцЧещЯУхЕ╝хо╣шбицДПцЦЗхнЧ
Ёпен	vfmwv	ф╕нцЧещЯУхЕ╝хо╣шбицДПцЦЗхнЧшгЬхЕЕ
язП	vfng	ф╕нцЧещЯУхЕ╝хо╣шбицДПцЦЗхнЧ
яд╜	vfnve	ф╕нцЧещЯУхЕ╝хо╣шбицДПцЦЗхнЧ
яжР	vfp	ф╕нцЧещЯУхЕ╝хо╣шбицДПцЦЗхнЧ
Ёпек	vfsu	ф╕нцЧещЯУхЕ╝хо╣шбицДПцЦЗхнЧшгЬхЕЕ
Ёпео	vfvmw	ф╕нцЧещЯУхЕ╝хо╣шбицДПцЦЗхнЧшгЬхЕЕ
Ёпел	vfvu	ф╕нцЧещЯУхЕ╝хо╣шбицДПцЦЗхнЧшгЬхЕЕ
Ёпе░	vfvvd	ф╕нцЧещЯУхЕ╝хо╣шбицДПцЦЗхнЧшгЬхЕЕ
Ёпем	vfyjj	ф╕нцЧещЯУхЕ╝хо╣шбицДПцЦЗхнЧшгЬхЕЕ
Ёпе▒	vfyqq	ф╕нцЧещЯУхЕ╝хо╣шбицДПцЦЗхнЧшгЬхЕЕ
Ёпбй	vggn	ф╕нцЧещЯУхЕ╝хо╣шбицДПцЦЗхнЧшгЬхЕЕ
т╝Ы	vi	х║╖чЖЩщГищжЦ
т╝│	vi	х║╖чЖЩщГищжЦ
т║У	vi	ф╕нцЧещЯУщГищжЦшгЬхЕЕ
ядФ	vid	ф╕нцЧещЯУхЕ╝хо╣шбицДПцЦЗхнЧ
яеЬ	vid	ф╕нцЧещЯУхЕ╝хо╣шбицДПцЦЗхнЧ
яж┐	vid	ф╕нцЧещЯУхЕ╝хо╣шбицДПцЦЗхнЧ
т╜╖	vif	х║╖чЖЩщГищжЦ
т║п	vif	ф╕нцЧещЯУщГищжЦшгЬхЕЕ
Ёпбз	vjce	ф╕нцЧещЯУхЕ╝хо╣шбицДПцЦЗхнЧшгЬхЕЕ
Ёпбб	vkuh	ф╕нцЧещЯУхЕ╝хо╣шбицДПцЦЗхнЧшгЬхЕЕ
ЁпаЭ	vl	ф╕нцЧещЯУхЕ╝хо╣шбицДПцЦЗхнЧшгЬхЕЕ
т╝Р	vl	х║╖чЖЩщГищжЦ
т║Г	vl	ф╕нцЧещЯУщГищжЦшгЬхЕЕ
уЗЯ	vl	ф╕нцЧещЯУчнЖчХл
ЁпзБ	vllmi	ф╕нцЧещЯУхЕ╝хо╣шбицДПцЦЗхнЧшгЬхЕЕ
т╜Щ	vlm	х║╖чЖЩщГищжЦ
яйй	vlyta	ф╕нцЧещЯУхЕ╝хо╣шбицДПцЦЗхнЧ
ялК	vlyta	ф╕нцЧещЯУхЕ╝хо╣шбицДПцЦЗхнЧ
уЗЬ	vm	ф╕нцЧещЯУчнЖчХл
ЁпдШ	vmf	ф╕нцЧещЯУхЕ╝хо╣шбицДПцЦЗхнЧшгЬхЕЕ
ЁпвШ	vmftf	ф╕нцЧещЯУхЕ╝хо╣шбицДПцЦЗхнЧшгЬхЕЕ
яз║	vmik	ф╕нцЧещЯУхЕ╝хо╣шбицДПцЦЗхнЧ
Ёпби	vmjx	ф╕нцЧещЯУхЕ╝хо╣шбицДПцЦЗхнЧшгЬхЕЕ
Ёпд╢	vmw	ф╕нцЧещЯУхЕ╝хо╣шбицДПцЦЗхнЧшгЬхЕЕ
уЗЮ	vn	ф╕нцЧещЯУчнЖчХл
т║Ф	vnm	ф╕нцЧещЯУщГищжЦшгЬхЕЕ
Ёпба	vp	ф╕нцЧещЯУхЕ╝хо╣шбицДПцЦЗхнЧшгЬхЕЕ
Ёпбг	vrvk	ф╕нцЧещЯУхЕ╝хо╣шбицДПцЦЗхнЧшгЬхЕЕ
уЗЙ	vs	ф╕нцЧещЯУчнЖчХл
Ёпбв	vsll	ф╕нцЧещЯУхЕ╝хо╣шбицДПцЦЗхнЧшгЬхЕЕ
Ёпбж	vsmb	ф╕нцЧещЯУхЕ╝хо╣шбицДПцЦЗхнЧшгЬхЕЕ
ЁпвВ	vvhxd	ф╕нцЧещЯУхЕ╝хо╣шбицДПцЦЗхнЧшгЬхЕЕ
т║░	vvm	ф╕нцЧещЯУщГищжЦшгЬхЕЕ
т╗б	vvmbu	ф╕нцЧещЯУщГищжЦшгЬхЕЕ
т╝о	vvv	х║╖чЖЩщГищжЦ
якА	vwhj	ф╕нцЧещЯУхЕ╝хо╣шбицДПцЦЗхнЧ
Ёпбе	vyjj	ф╕нцЧещЯУхЕ╝хо╣шбицДПцЦЗхнЧшгЬхЕЕ
якБ	vyyp	ф╕нцЧещЯУхЕ╝хо╣шбицДПцЦЗхнЧ
т╜е	w	х║╖чЖЩщГищжЦ
т┐╡	wb	шбицДПцЦЗхнЧцППш┐░хнЧчмж
т║▓	wc	ф╕нцЧещЯУщГищжЦшгЬхЕЕ
Ёпг▓	wfno	ф╕нцЧещЯУхЕ╝хо╣шбицДПцЦЗхнЧшгЬхЕЕ
язй	wg	ф╕нцЧещЯУхЕ╝хо╣шбицДПцЦЗхнЧ
т╛е	wg	х║╖чЖЩщГищжЦ
т┐К	wgf	х║╖чЖЩщГищжЦ
яи║	wgfg	ф╕нцЧещЯУхЕ╝хо╣шбицДПцЦЗхнЧ
яе╢	wher	ф╕нцЧещЯУхЕ╝хо╣шбицДПцЦЗхнЧ
ЁпбН	wiyw	ф╕нцЧещЯУхЕ╝хо╣шбицДПцЦЗхнЧшгЬхЕЕ
т╜П	wj	х║╖чЖЩщГищжЦ
т┐░	wl	шбицДПцЦЗхнЧцППш┐░хнЧчмж
ЁпеД	wle	ф╕нцЧещЯУхЕ╝хо╣шбицДПцЦЗхнЧшгЬхЕЕ
яйЪ	wljka	ф╕нцЧещЯУхЕ╝хо╣шбицДПцЦЗхнЧ
т║л	wll	ф╕нцЧещЯУщГищжЦшгЬхЕЕ
т┐▓	wll	шбицДПцЦЗхнЧцППш┐░хнЧчмж
Ёпе┤	wlowy	ф╕нцЧещЯУхЕ╝хо╣шбицДПцЦЗхнЧшгЬхЕЕ
язж	wlpog	ф╕нцЧещЯУхЕ╝хо╣шбицДПцЦЗхнЧ
ядП	wlvfg	ф╕нцЧещЯУхЕ╝хо╣шбицДПцЦЗхнЧ
Ёпе╖	wlvfv	ф╕нцЧещЯУхЕ╝хо╣шбицДПцЦЗхнЧшгЬхЕЕ
Ёпе╢	wlvvd	ф╕нцЧещЯУхЕ╝хо╣шбицДПцЦЗхнЧшгЬхЕЕ
т┐╕	wml	шбицДПцЦЗхнЧцППш┐░хнЧчмж
уА╛	wmq	ф╕нцЧещЯУциЩщ╗ЮчмжшЩЯ
т┐╣	wn	шбицДПцЦЗхнЧцППш┐░хнЧчмж
яжй	woml	ф╕нцЧещЯУхЕ╝хо╣шбицДПцЦЗхнЧ
уА╛	woq	ф╕нцЧещЯУциЩщ╗ЮчмжшЩЯ
т┐┤	wr	шбицДПцЦЗхнЧцППш┐░хнЧчмж
ЁпбЛ	wrjw	ф╕нцЧещЯУхЕ╝хо╣шбицДПцЦЗхнЧшгЬхЕЕ
т┐╖	ws	шбицДПцЦЗхнЧцППш┐░хнЧчмж
яев	wtc	ф╕нцЧещЯУхЕ╝хо╣шбицДПцЦЗхнЧ
Ёпд╕	wtc	ф╕нцЧещЯУхЕ╝хо╣шбицДПцЦЗхнЧшгЬхЕЕ
Ёпд╖	wtt	ф╕нцЧещЯУхЕ╝хо╣шбицДПцЦЗхнЧшгЬхЕЕ
т┐╢	wu	шбицДПцЦЗхнЧцППш┐░хнЧчмж
т┐║	wv	шбицДПцЦЗхнЧцППш┐░хнЧчмж
яеП	wvif	ф╕нцЧещЯУхЕ╝хо╣шбицДПцЦЗхнЧ
т┐╗	ww	шбицДПцЦЗхнЧцППш┐░хнЧчмж
яеК	wwwg	ф╕нцЧещЯУхЕ╝хо╣шбицДПцЦЗхнЧ
ЁпзФ	wybuc	ф╕нцЧещЯУхЕ╝хо╣шбицДПцЦЗхнЧшгЬхЕЕ
т║Я	wyi	ф╕нцЧещЯУщГищжЦшгЬхЕЕ
уЗг	xxxxx	ф╕нцЧещЯУчнЖчХл
т╝Ш	y	х║╖чЖЩщГищжЦ
якУ	ybhg	ф╕нцЧещЯУхЕ╝хо╣шбицДПцЦЗхнЧ
ЁпгЩ	ybmg	ф╕нцЧещЯУхЕ╝хо╣шбицДПцЦЗхнЧшгЬхЕЕ
язк	ybog	ф╕нцЧещЯУхЕ╝хо╣шбицДПцЦЗхнЧ
язД	ybysp	ф╕нцЧещЯУхЕ╝хо╣шбицДПцЦЗхнЧ
т┐У	ybysp	х║╖чЖЩщГищжЦ
язС	yc	ф╕нцЧещЯУхЕ╝хо╣шбицДПцЦЗхнЧ
Ёпг▒	ycno	ф╕нцЧещЯУхЕ╝хо╣шбицДПцЦЗхнЧшгЬхЕЕ
ЁпгК	ycok	ф╕нцЧещЯУхЕ╝хо╣шбицДПцЦЗхнЧшгЬхЕЕ
т╜Б	ye	х║╖чЖЩщГищжЦ
Ёпж╡	ygmjs	ф╕нцЧещЯУхЕ╝хо╣шбицДПцЦЗхнЧшгЬхЕЕ
т╝┤	yh	х║╖чЖЩщГищжЦ
яйк	yhmbc	ф╕нцЧещЯУхЕ╝хо╣шбицДПцЦЗхнЧ
ялМ	yhmbc	ф╕нцЧещЯУхЕ╝хо╣шбицДПцЦЗхнЧ
т╜Е	yhs	х║╖чЖЩщГищжЦ
т╛Р	yhv	х║╖чЖЩщГищжЦ
Ёпзб	yhxg	ф╕нцЧещЯУхЕ╝хо╣шбицДПцЦЗхнЧшгЬхЕЕ
ЁпжВ	yib	ф╕нцЧещЯУхЕ╝хо╣шбицДПцЦЗхнЧшгЬхЕЕ
яй┤	yihu	ф╕нцЧещЯУхЕ╝хо╣шбицДПцЦЗхнЧ
ЁпаН	yihu	ф╕нцЧещЯУхЕ╝хо╣шбицДПцЦЗхнЧшгЬхЕЕ
яеб	yioj	ф╕нцЧещЯУхЕ╝хо╣шбицДПцЦЗхнЧ
язЫ	yioj	ф╕нцЧещЯУхЕ╝хо╣шбицДПцЦЗхнЧ
т╜Г	yj	х║╖чЖЩщГищжЦ
ЁпзЦ	yjhec	ф╕нцЧещЯУхЕ╝хо╣шбицДПцЦЗхнЧшгЬхЕЕ
яжЪ	yjwj	ф╕нцЧещЯУхЕ╝хо╣шбицДПцЦЗхнЧ
ЁпиА	yjyjc	ф╕нцЧещЯУхЕ╝хо╣шбицДПцЦЗхнЧшгЬхЕЕ
ЁпиП	yjyjf	ф╕нцЧещЯУхЕ╝хо╣шбицДПцЦЗхнЧшгЬхЕЕ
Ёпзг	yjyjl	ф╕нцЧещЯУхЕ╝хо╣шбицДПцЦЗхнЧшгЬхЕЕ
т╜В	yk	х║╖чЖЩщГищжЦ
язГ	ykcf	ф╕нцЧещЯУхЕ╝хо╣шбицДПцЦЗхнЧ
т╗м	ykll	ф╕нцЧещЯУщГищжЦшгЬхЕЕ
язн	ykr	ф╕нцЧещЯУхЕ╝хо╣шбицДПцЦЗхнЧ
т╗л	yksl	ф╕нцЧещЯУщГищжЦшгЬхЕЕ
т╜М	ylm	х║╖чЖЩщГищжЦ
т║б	ym	ф╕нцЧещЯУщГищжЦшгЬхЕЕ
Ёпза	ymbg	ф╕нцЧещЯУхЕ╝хо╣шбицДПцЦЗхнЧшгЬхЕЕ
Ёпг│	ymihf	ф╕нцЧещЯУхЕ╝хо╣шбицДПцЦЗхнЧшгЬхЕЕ
Ёпаг	ymln	ф╕нцЧещЯУхЕ╝хо╣шбицДПцЦЗхнЧшгЬхЕЕ
т╛Ф	ymmr	х║╖чЖЩщГищжЦ
ЁпвС	ymt	ф╕нцЧещЯУхЕ╝хо╣шбицДПцЦЗхнЧшгЬхЕЕ
ЁпвТ	ymt	ф╕нцЧещЯУхЕ╝хо╣шбицДПцЦЗхнЧшгЬхЕЕ
т╗н	ymufd	ф╕нцЧещЯУщГищжЦшгЬхЕЕ
т╗о	ymuo	ф╕нцЧещЯУщГищжЦшгЬхЕЕ
т┐Т	ymuoo	х║╖чЖЩщГищжЦ
яие	ynai	ф╕нцЧещЯУхЕ╝хо╣шбицДПцЦЗхнЧ
яйз	ynai	ф╕нцЧещЯУхЕ╝хо╣шбицДПцЦЗхнЧ
т║Ю	yni	ф╕нцЧещЯУщГищжЦшгЬхЕЕ
т╗Н	yno	ф╕нцЧещЯУщГищжЦшгЬхЕЕ
Ёпаа	yoln	ф╕нцЧещЯУхЕ╝хо╣шбицДПцЦЗхнЧшгЬхЕЕ
ЁпзД	yoo	ф╕нцЧещЯУхЕ╝хо╣шбицДПцЦЗхнЧшгЬхЕЕ
т╛М	yp	х║╖чЖЩщГищжЦ
яеВ	ypg	ф╕нцЧещЯУхЕ╝хо╣шбицДПцЦЗхнЧ
т╗Б	yphn	ф╕нцЧещЯУщГищжЦшгЬхЕЕ
яеЕ	ypsj	ф╕нцЧещЯУхЕ╝хо╣шбицДПцЦЗхнЧ
Ёпж│	ypsm	ф╕нцЧещЯУхЕ╝хо╣шбицДПцЦЗхнЧшгЬхЕЕ
яд│	ypwbt	ф╕нцЧещЯУхЕ╝хо╣шбицДПцЦЗхнЧ
яд╢	ypwks	ф╕нцЧещЯУхЕ╝хо╣шбицДПцЦЗхнЧ
Ёпж┤	ypwks	ф╕нцЧещЯУхЕ╝хо╣шбицДПцЦЗхнЧшгЬхЕЕ
як╝	yrapp	ф╕нцЧещЯУхЕ╝хо╣шбицДПцЦЗхнЧ
яйв	yrapv	ф╕нцЧещЯУхЕ╝хо╣шбицДПцЦЗхнЧ
як╣	yrbgr	ф╕нцЧещЯУхЕ╝хо╣шбицДПцЦЗхнЧ
т╛╝	yrbr	х║╖чЖЩщГищжЦ
яе╖	yrbu	ф╕нцЧещЯУхЕ╝хо╣шбицДПцЦЗхнЧ
ЁпзО	yrcr	ф╕нцЧещЯУхЕ╝хо╣шбицДПцЦЗхнЧшгЬхЕЕ
яеп	yrcru	ф╕нцЧещЯУхЕ╝хо╣шбицДПцЦЗхнЧ
яжб	yrcru	ф╕нцЧещЯУхЕ╝хо╣шбицДПцЦЗхнЧ
яеЪ	yrgwc	ф╕нцЧещЯУхЕ╝хо╣шбицДПцЦЗхнЧ
ЁпзП	yrihl	ф╕нцЧещЯУхЕ╝хо╣шбицДПцЦЗхнЧшгЬхЕЕ
яив	yrjka	ф╕нцЧещЯУхЕ╝хо╣шбицДПцЦЗхнЧ
як║	yrjka	ф╕нцЧещЯУхЕ╝хо╣шбицДПцЦЗхнЧ
ЁпзН	yrmg	ф╕нцЧещЯУхЕ╝хо╣шбицДПцЦЗхнЧшгЬхЕЕ
ЁпзМ	yrmms	ф╕нцЧещЯУхЕ╝хо╣шбицДПцЦЗхнЧшгЬхЕЕ
яеБ	yromb	ф╕нцЧещЯУхЕ╝хо╣шбицДПцЦЗхнЧ
як╛	yromn	ф╕нцЧещЯУхЕ╝хо╣шбицДПцЦЗхнЧ
ЁпзР	yromv	ф╕нцЧещЯУхЕ╝хо╣шбицДПцЦЗхнЧшгЬхЕЕ
як╗	yrqmb	ф╕нцЧещЯУхЕ╝хо╣шбицДПцЦЗхнЧ
як┐	yrtag	ф╕нцЧещЯУхЕ╝хо╣шбицДПцЦЗхнЧ
яеЭ	yrtkr	ф╕нцЧещЯУхЕ╝хо╣шбицДПцЦЗхнЧ
як╜	yrtkr	ф╕нцЧещЯУхЕ╝хо╣шбицДПцЦЗхнЧ
яйг	yrtlm	ф╕нцЧещЯУхЕ╝хо╣шбицДПцЦЗхнЧ
яз╝	yryia	ф╕нцЧещЯУхЕ╝хо╣шбицДПцЦЗхнЧ
яе╜	yryrf	ф╕нцЧещЯУхЕ╝хо╣шбицДПцЦЗхнЧ
ялГ	yseq	ф╕нцЧещЯУхЕ╝хо╣шбицДПцЦЗхнЧ
яжГ	ysohv	ф╕нцЧещЯУхЕ╝хо╣шбицДПцЦЗхнЧ
яз╖	yt	ф╕нцЧещЯУхЕ╝хо╣шбицДПцЦЗхнЧ
т╜┤	yt	х║╖чЖЩщГищжЦ
ЁпгХ	yta	ф╕нцЧещЯУхЕ╝хо╣шбицДПцЦЗхнЧшгЬхЕЕ
т╛│	yta	х║╖чЖЩщГищжЦ
т╛Я	ytj	х║╖чЖЩщГищжЦ
ЁпеЮ	ytjbc	ф╕нцЧещЯУхЕ╝хо╣шбицДПцЦЗхнЧшгЬхЕЕ
ЁпеЭ	ytpbc	ф╕нцЧещЯУхЕ╝хо╣шбицДПцЦЗхнЧшгЬхЕЕ
яиЬ	ytqmb	ф╕нцЧещЯУхЕ╝хо╣шбицДПцЦЗхнЧ
ялИ	ytqmb	ф╕нцЧещЯУхЕ╝хо╣шбицДПцЦЗхнЧ
ЁпеЯ	ytsyj	ф╕нцЧещЯУхЕ╝хо╣шбицДПцЦЗхнЧшгЬхЕЕ
т╗п	ytwu	ф╕нцЧещЯУщГищжЦшгЬхЕЕ
ЁпиЭ	yuyjj	ф╕нцЧещЯУхЕ╝хо╣шбицДПцЦЗхнЧшгЬхЕЕ
ялА	yvfe	ф╕нцЧещЯУхЕ╝хо╣шбицДПцЦЗхнЧ
т╜Ю	yvi	х║╖чЖЩщГищжЦ
ЁпвБ	yvvv	ф╕нцЧещЯУхЕ╝хо╣шбицДПцЦЗхнЧшгЬхЕЕ
язз	ywgv	ф╕нцЧещЯУхЕ╝хо╣шбицДПцЦЗхнЧ
т┐Д	ywii	х║╖чЖЩщГищжЦ
т╗з	ywk	ф╕нцЧещЯУщГищжЦшгЬхЕЕ
ядУ	ywlg	ф╕нцЧещЯУхЕ╝хо╣шбицДПцЦЗхнЧ
т┐С	yx	х║╖чЖЩщГищжЦ
якв	yyvin	ф╕нцЧещЯУхЕ╝хо╣шбицДПцЦЗхнЧ